border_size=1
usage=map

Wo, Wo, Ww, Wo, Wo, Wo, Wo, Wo, Wo, Wo, Wo, Wo, Wo, Wo, Wo, Wo, Wo, Wo, Wo, Wo, Ww, Wo, Wo, Wo, Wo, Wo, Wo, Wo, Wo, Wo, Ww, Wo, Wo
Wo, Ww, Ww, Wo, Ww, Ww, Ww, Wo, Wo, Wo, Wo, Wo, Ww, Ww, Ww, Wo, Wo, Wo, Wo, Ww, Wo, Ww, Ww, Ww, Ww, Ww, Ww, Ww, Ww, Ww, Ww, Ww, Wo
Wo, Wo, Ww, Ww, Ww, Wo, Wo, Ww, Wo, Wo, Ww, Ww, Wo, Ww, Wo, Wo, Mm^Xm, Wo, Wo, Wo, Ww, Ww, Wo, Ww, Ww, Ww, Wo, Wo, Wo, Wo, Ww, Ww, Wo
Wo, Wo, Wo, Ww, Wo, Wo, Ww, Ww, Ww, Ww, Wo, Wo, Wo, Wo, Mm^Xm, Mm^Xm, Mm^Xm, Mm^Xm, Mm^Xm, Wo, Wo, Ww, Wo, Wo, Ww, Wo, Wo, Wo, Wo, Ww, Wo, Wo, Wo
Wo, Ww, Ww, Wo, Ww, Ww, Wo, Ww, Wo, Wo, Wo, Wo, Mm^Xm, Mm^Xm, Mm^Xm, Mm^Xm, Mm^Xm, Mm^Xm, Mm^Xm, Mm^Xm, Mm^Xm, Wo, Wo, Wo, Ww, Ww, Ww, Ww, Wo, Ww, Wo, Wo, Wo
Wo, Ww, Wo, Ww, Ww, Wo, Wo, Ww, Wo, Wo, Mm^Xm, Mm^Xm, Mm^Xm, Mm^Xm, Mm^Xm, Mm^Xm, Ss^Vhs, Mm^Xm, Mm^Xm, Mm^Xm, Mm^Xm, Mm^Xm, Mm^Xm, Wo, Ww, Wo, Wo, Wo, Wo, Wo, Ww, Ww, Wo
Wo, Wo, Ww, Ww, Wo, Wo, Wo, Wo, Mm^Xm, Mm^Xm, Mm^Xm, Mm^Xm, Mm^Xm, Mm^Xm, Ss, Ss, Ss, Ss, Ss, Mm^Xm, Mm^Xm, Mm^Xm, Mm^Xm, Mm^Xm, Mm^Xm, Ww, Wo, Wo, Wo, Wo, Ww, Wo, Wo
Wo, Wo, Wo, Wo, Wo, Wo, Mm^Xm, Mm^Xm, Mm^Xm, Mm^Xm, Mm^Xm, Mm^Xm, Ss, Ss, Ss^Vhs, Ss, 1 Khw, Ss, Ss^Vhs, Ss, Ss, Mm^Xm, Mm^Xm, Mm^Xm, Mm^Xm, Mm^Xm, Mm^Xm, Wo, Wo, Wo, Wo, Ww, Wo
Wo, Wo, Wo, Wo, Mm^Xm, Mm^Xm, Mm^Xm, Mm^Xm, Mm^Xm, Mm^Xm, Mm^Xm, Mm^Xm, Khw, Ss, Chw, Chw, Chw, Chw, Chw, Ss, Khw, Mm^Xm, Mm^Xm, Mm^Xm, Mm^Xm, Mm^Xm, Mm^Xm, Mm^Xm, Mm^Xm, Wo, Wo, Wo, Wo
Wo, Wo, Mm^Xm, Mm^Xm, Mm^Xm, Mm^Xm, Mm^Xm, Mm^Xm, Ss, Ss, Khw, Wwr, Chw, Wwf, Chw, Chw, Chw, Chw, Chw, Wwf, Chw, Wwr, Khw, Sm, Sm, Mm^Xm, Mm^Xm, Mm^Xm, Mm^Xm, Mm^Xm, Mm^Xm, Wo, Wo
Wo, Wo, Mm^Xm, Mm^Xm, Mm^Xm, Mm^Xm, Ss, Ss, Ss^Vhs, Ss, Wwf, Chw, Ww^Vm, Wwf, Chw, Chw, Wwf, Chw, Chw, Wwf, Ww^Vm, Chw, Wwf, Sm, Sm^Vhs, Sm, Sm, Mm^Xm, Mm^Xm, Mm^Xm, Mm^Xm, Wo, Wo
Wo, Wo, Mm^Xm, Mm^Xm, Mm^Xm, Ss^Vhs, Ss, Ss, Chw, Chw, Chw, Wwf, Ww, Ww, Ww, Khw, Wwf, Khw, Ww, Ww, Ww, Wwf, Chw, Chw, Chw, Sm, Sm, Sm^Vhs, Mm^Xm, Mm^Xm, Mm^Xm, Wo, Wo
Wo, Wo, Mm^Xm, Mm^Xm, Mm^Xm, Ss, Ss, 6 Khw, Chw, Chw, Chw, Chw, Ww, Wwr, Wwr, Ww, Khw, Ww, Wwr, Wwr, Ww, Chw, Chw, Chw, Chw, 2 Khw, Sm, Sm, Mm^Xm, Mm^Xm, Mm^Xm, Wo, Wo
Wo, Wo, Mm^Xm, Mm^Xm, Mm^Xm, Ss, Ss^Vhs, Chw, Chw, Chw, Wwf, Khw, Ww, Wwr, Ww^Vm, Ww, Chw, Ww, Ww^Vm, Wwr, Ww, Khw, Wwf, Chw, Chw, Chw, Sm^Vhs, Sm, Mm^Xm, Mm^Xm, Mm^Xm, Wo, Wo
Wo, Wo, Mm^Xm, Mm^Xm, Mm^Xm, Ss, Ss, Chw, Chw, Chw, Khw, Wwf, Khw, Ww, Chw, Chw, Ww, Chw, Chw, Ww, Khw, Wwf, Khw, Chw, Chw, Chw, Sm, Sm, Mm^Xm, Mm^Xm, Mm^Xm, Wo, Wo
Wo, Wo, Mm^Xm, Mm^Xm, Mm^Xm, Ss, Khw, Wwf, Wwf, Chw, Ww, Ww, Ww, Chw, Ww, Ww, Ww, Ww, Ww, Chw, Ww, Ww, Ww, Chw, Wwf, Wwf, Khw, Sm, Mm^Xm, Mm^Xm, Mm^Xm, Wo, Wo
Wo, Wo, Mm^Xm, Mm^Xm, Mm^Xm, Mm^Xm, Wwr, Chw, Ww^Vm, Ww, Wwr, Wwr, Ww^Vm, Chw, Ww, Ss, Ss^Vhs, Ss, Ww, Chw, Ww^Vm, Wwr, Wwr, Ww, Ww^Vm, Chw, Wwr, Mm^Xm, Mm^Xm, Mm^Xm, Mm^Xm, Wo, Wo
Wo, Wo, Mm^Xm, Mm^Xm, Mm^Xm, Mm^Xm, Khw, Chw, Wwf, Ww, Ww, Wwr, Ww, Chw, Ww, Ww, Ss, Ww, Ww, Chw, Ww, Wwr, Ww, Ww, Wwf, Chw, Khw, Mm^Xm, Mm^Xm, Mm^Xm, Mm^Xm, Wo, Wo
Wo, Wo, Mm^Xm, Mm^Xm, Mm^Xm, Sm, Sm, Wwf, Chw, Chw, Khw, Ww, Khw, Chw, Chw, Ww, Ww, Ww, Chw, Chw, Khw, Ww, Khw, Chw, Chw, Wwf, Ss, Ss, Mm^Xm, Mm^Xm, Mm^Xm, Wo, Wo
Wo, Wo, Mm^Xm, Mm^Xm, Mm^Xm, Sm, Sm^Vhs, Chw, Chw, Chw, Wwf, Wwf, Ww, Ww, Ww^Vm, Chw, Chw, Chw, Ww^Vm, Ww, Ww, Wwf, Wwf, Chw, Chw, Chw, Ss^Vhs, Ss, Mm^Xm, Mm^Xm, Mm^Xm, Wo, Wo
Wo, Wo, Mm^Xm, Mm^Xm, Mm^Xm, Sm, Sm, Chw, Chw, Chw, Chw, Khw, Ww, Wwr, Wwr, Ww, Khw, Ww, Wwr, Wwr, Ww, Khw, Chw, Chw, Chw, Chw, Ss, Ss, Mm^Xm, Mm^Xm, Mm^Xm, Wo, Wo
Wo, Wo, Mm^Xm, Mm^Xm, Mm^Xm, Sm, Sm, 5 Khw, Chw, Chw, Chw, Chw, Ww, Wwr, Ww, Ww, Wwf, Ww, Ww, Wwr, Ww, Chw, Chw, Chw, Chw, 3 Khw, Ss, Ss, Mm^Xm, Mm^Xm, Mm^Xm, Wo, Wo
Wo, Wo, Mm^Xm, Mm^Xm, Mm^Xm, Sm^Vhs, Sm, Sm, Sm^Vhs, Chw, Wwf, Wwf, Ww^Vm, Ww, Chw, Khw, Wwf, Khw, Chw, Ww, Ww^Vm, Wwf, Wwf, Chw, Ss^Vhs, Ss, Ss, Ss^Vhs, Mm^Xm, Mm^Xm, Mm^Xm, Wo, Wo
Wo, Wo, Mm^Xm, Mm^Xm, Mm^Xm, Mm^Xm, Mm^Xm, Sm, Sm, Sm, Khw, Chw, Chw, Wwf, Chw, Chw, Chw, Chw, Chw, Wwf, Chw, Chw, Khw, Ss, Ss, Ss, Mm^Xm, Mm^Xm, Mm^Xm, Mm^Xm, Mm^Xm, Wo, Wo
Wo, Wo, Wo, Mm^Xm, Mm^Xm, Mm^Xm, Mm^Xm, Mm^Xm, Mm^Xm, Sm, Mm^Xm, Wwr, Khw, Wwf, Chw, Chw, Chw, Chw, Chw, Wwf, Khw, Wwr, Mm^Xm, Ss, Mm^Xm, Mm^Xm, Mm^Xm, Mm^Xm, Mm^Xm, Mm^Xm, Wo, Wo, Wo
Wo, Wo, Wo, Wo, Ww, Mm^Xm, Mm^Xm, Mm^Xm, Mm^Xm, Mm^Xm, Mm^Xm, Mm^Xm, Ss, Ss, Ss^Vhs, Chw, 4 Khw, Chw, Ss^Vhs, Ss, Ss, Mm^Xm, Mm^Xm, Mm^Xm, Mm^Xm, Mm^Xm, Mm^Xm, Mm^Xm, Wo, Wo, Ww, Wo, Wo
Wo, Wo, Wo, Ww, Ww, Wo, Wo, Mm^Xm, Mm^Xm, Mm^Xm, Mm^Xm, Mm^Xm, Mm^Xm, Ss, Ss, Ss, Ss, Ss, Ss, Ss, Mm^Xm, Mm^Xm, Mm^Xm, Mm^Xm, Mm^Xm, Mm^Xm, Wo, Wo, Wo, Wo, Ww, Wo, Wo
Wo, Ww, Ww, Ww, Ww, Ww, Ww, Wo, Wo, Mm^Xm, Mm^Xm, Mm^Xm, Mm^Xm, Mm^Xm, Mm^Xm, Ss, Ss^Vhs, Ss, Mm^Xm, Mm^Xm, Mm^Xm, Mm^Xm, Mm^Xm, Mm^Xm, Wo, Ww, Wo, Wo, Wo, Wo, Ww, Wo, Wo
Ww, Wo, Ww, Ww, Ww, Ww, Ww, Wo, Wo, Wo, Wo, Mm^Xm, Mm^Xm, Mm^Xm, Mm^Xm, Mm^Xm, Mm^Xm, Mm^Xm, Mm^Xm, Mm^Xm, Mm^Xm, Mm^Xm, Wo, Wo, Ww, Wo, Ww, Ww, Wo, Ww, Wo, Wo, Wo
Ww, Wo, Ww, Ww, Wo, Ww, Ww, Ww, Ww, Wo, Wo, Wo, Wo, Mm^Xm, Mm^Xm, Mm^Xm, Mm^Xm, Mm^Xm, Mm^Xm, Mm^Xm, Wo, Wo, Ww, Ww, Wo, Ww, Ww, Wo, Ww, Ww, Wo, Wo, Wo
Ww, Wo, Ww, Ww, Wo, Wo, Ww, Wo, Ww, Ww, Ww, Wo, Wo, Wo, Wo, Mm^Xm, Mm^Xm, Mm^Xm, Wo, Wo, Ww, Wo, Ww, Ww, Wo, Wo, Wo, Ww, Ww, Ww, Wo, Wo, Wo
Wo, Wo, Wo, Ww, Wo, Wo, Wo, Ww, Wo, Ww, Ww, Wo, Wo, Wo, Wo, Wo, Wo, Wo, Wo, Wo, Ww, Ww, Wo, Ww, Ww, Wo, Ww, Wo, Ww, Ww, Wo, Wo, Wo
Wo, Wo, Wo, Wo, Wo, Wo, Wo, Wo, Wo, Wo, Wo, Ww, Ww, Ww, Wo, Wo, Wo, Wo, Wo, Wo, Wo, Wo, Wo, Ww, Wo, Ww, Wo, Ww, Wo, Ww, Wo, Wo, Wo
