border_size=1
usage=map

Ql          , Ql          , Ql          , Ql          , Ql          , Ql          , Ql          , Ql          , Ql          , Ql          , Ql          , Ql          , Ql          , Ql          , Ql          , Ql          , Ql          , Ql          , Ql          , Ql          , Ql          , Ql          , Ql          , Ql          , Ql          , Ql          , Ql          , Ql          , Ql          , Ql          , Ql          , Ql          , Ql          
Ql          , Ql          , Ql          , Ql          , Ql          , Ql          , Ql          , Ql          , Ql          , Ql          , Ql          , Ql          , Ql          , Ql          , Ql          , Ql          , Ql          , Ql          , Ql          , Ql          , Ql          , Ql          , Ql          , Ql          , Ql          , Ql          , Ql          , Ql          , Ql          , Ql          , Ql          , Ql          , Ql          
Ql          , Ql          , Ql          , Ql          , Ql          , Ql          , Ql          , Ql          , Ql          , Ql          , Ql          , Ql          , Ql          , Ql          , Ql          , Ql          , Xu          , Ql          , Ql          , Ql          , Ql          , Ql          , Ql          , Ql          , Ql          , Ql          , Ql          , Ql          , Ql          , Ql          , Ql          , Ql          , Ql          
Ql          , Ql          , Ql          , Ql          , Ql          , Ql          , Ql          , Ql          , Ql          , Ql          , Ql          , Ql          , Ql          , Ql          , Xu          , Xu          , Xu          , Xu          , Xu          , Ql          , Ql          , Ql          , Ql          , Ql          , Ql          , Ql          , Ql          , Ql          , Ql          , Ql          , Ql          , Ql          , Ql          
Ql          , Ql          , Ql          , Ql          , Ql          , Ql          , Ql          , Ql          , Ql          , Ql          , Ql          , Ql          , Xu          , Xu          , Xu          , Xu          , Xu          , Xu          , Xu          , Xu          , Xu          , Ql          , Ql          , Ql          , Ql          , Ql          , Ql          , Ql          , Ql          , Ql          , Ql          , Ql          , Ql          
Ql          , Ql          , Ql          , Ql          , Ql          , Ql          , Ql          , Ql          , Ql          , Ql          , Xu          , Xu          , Xu          , Xu          , Xu          , Xu          , Uu^Vud      , Xu          , Xu          , Xu          , Xu          , Xu          , Xu          , Ql          , Ql          , Ql          , Ql          , Ql          , Ql          , Ql          , Ql          , Ql          , Ql          
Ql          , Ql          , Ql          , Ql          , Ql          , Ql          , Ql          , Ql          , Xu          , Xu          , Xu          , Xu          , Xu          , Xu          , Uu          , Uu^Uf       , Uu          , Uu^Uf       , Uu          , Xu          , Xu          , Xu          , Xu          , Xu          , Xu          , Ql          , Ql          , Ql          , Ql          , Ql          , Ql          , Ql          , Ql          
Ql          , Ql          , Ql          , Ql          , Ql          , Ql          , Xu          , Xu          , Xu          , Xu          , Xu          , Xu          , Uh          , Uh          , Uu^Vud      , Uu          , 1 Kud       , Uu          , Uu^Vud      , Uh          , Uh          , Xu          , Xu          , Xu          , Xu          , Xu          , Xu          , Ql          , Ql          , Ql          , Ql          , Ql          , Ql          
Ql          , Ql          , Ql          , Ql          , Xu          , Xu          , Xu          , Xu          , Xu          , Xu          , Xu          , Xu          , Kud         , Uh          , Cud         , Cud         , Cud         , Cud         , Cud         , Uh          , Kud         , Xu          , Xu          , Xu          , Xu          , Xu          , Xu          , Xu          , Xu          , Ql          , Ql          , Ql          , Ql          
Ql          , Ql          , Xu          , Xu          , Xu          , Xu          , Xu          , Xu          , Uh          , Uh          , Kud         , Uh          , Cud         , Uu          , Cud         , Cud         , Cud         , Cud         , Cud         , Uu          , Cud         , Uh          , Kud         , Uh          , Uh          , Xu          , Xu          , Xu          , Xu          , Xu          , Xu          , Ql          , Ql          
Ql          , Ql          , Xu          , Xu          , Xu          , Xu          , Uu^Uf       , Uu          , Uu^Vud      , Uh          , Uu          , Cud         , Uu^Vu       , Uu          , Cud         , Cud         , Uh          , Cud         , Cud         , Uu          , Uu^Vu       , Cud         , Uu          , Uh          , Uu^Vud      , Uu          , Uu^Uf       , Xu          , Xu          , Xu          , Xu          , Ql          , Ql          
Ql          , Ql          , Xu          , Xu          , Xu          , Uu^Vud      , Uu          , Uu          , Cud         , Cud         , Cud         , Uu          , Uu          , Uu          , Uu          , Kud         , Uh          , Kud         , Uu          , Uu          , Uu          , Uu          , Cud         , Cud         , Cud         , Uu          , Uu          , Uu^Vud      , Xu          , Xu          , Xu          , Ql          , Ql          
Ql          , Ql          , Xu          , Xu          , Xu          , Uu^Uf       , Uu          , 6 Kud       , Cud         , Cud         , Cud         , Cud         , Uu          , Uu^Uf       , Uu^Uf       , Uu          , Kud         , Uu          , Uu^Uf       , Uu^Uf       , Uu          , Cud         , Cud         , Cud         , Cud         , 2 Kud       , Uu          , Uu^Uf       , Xu          , Xu          , Xu          , Ql          , Ql          
Ql          , Ql          , Xu          , Xu          , Xu          , Uu          , Uu^Vud      , Cud         , Cud         , Cud         , Uh          , Kud         , Uu          , Uu^Uf       , Uu^Vu       , Uu          , Cud         , Uu          , Uu^Vu       , Uu^Uf       , Uu          , Kud         , Uh          , Cud         , Cud         , Cud         , Uu^Vud      , Uu          , Xu          , Xu          , Xu          , Ql          , Ql          
Ql          , Ql          , Xu          , Xu          , Xu          , Uh          , Uh          , Cud         , Cud         , Cud         , Kud         , Uh          , Kud         , Uu          , Cud         , Cud         , Uh          , Cud         , Cud         , Uu          , Kud         , Uh          , Kud         , Cud         , Cud         , Cud         , Uh          , Uh          , Xu          , Xu          , Xu          , Ql          , Ql          
Ql          , Ql          , Xu          , Xu          , Xu          , Uh          , Kud         , Uu          , Uu          , Cud         , Uu          , Uu          , Uu          , Cud         , Uh          , Uu          , Uu          , Uu          , Uh          , Cud         , Uu          , Uu          , Uu          , Cud         , Uu          , Uu          , Kud         , Uh          , Xu          , Xu          , Xu          , Ql          , Ql          
Ql          , Ql          , Xu          , Xu          , Xu          , Xu          , Uh          , Cud         , Uu^Vu       , Uu          , Uu^Uf       , Uu^Uf       , Uu^Vu       , Cud         , Uu          , Uu^Uf       , Uu^Vud      , Uu^Uf       , Uu          , Cud         , Uu^Vu       , Uu^Uf       , Uu^Uf       , Uu          , Uu^Vu       , Cud         , Uh          , Xu          , Xu          , Xu          , Xu          , Ql          , Ql          
Ql          , Ql          , Xu          , Xu          , Xu          , Xu          , Kud         , Cud         , Uu          , Uu          , Uu          , Uu^Uf       , Uu          , Cud         , Uh          , Uu          , Uu^Uf       , Uu          , Uh          , Cud         , Uu          , Uu^Uf       , Uu          , Uu          , Uu          , Cud         , Kud         , Xu          , Xu          , Xu          , Xu          , Ql          , Ql          
Ql          , Ql          , Xu          , Xu          , Xu          , Uh          , Uh          , Uu          , Cud         , Cud         , Kud         , Uu          , Kud         , Cud         , Cud         , Uu          , Uh          , Uu          , Cud         , Cud         , Kud         , Uu          , Kud         , Cud         , Cud         , Uu          , Uh          , Uh          , Xu          , Xu          , Xu          , Ql          , Ql          
Ql          , Ql          , Xu          , Xu          , Xu          , Uh          , Uu^Vud      , Cud         , Cud         , Cud         , Uh          , Uh          , Uu          , Uu          , Uu^Vu       , Cud         , Cud         , Cud         , Uu^Vu       , Uu          , Uu          , Uh          , Uh          , Cud         , Cud         , Cud         , Uu^Vud      , Uh          , Xu          , Xu          , Xu          , Ql          , Ql          
Ql          , Ql          , Xu          , Xu          , Xu          , Uu          , Uu          , Cud         , Cud         , Cud         , Cud         , Kud         , Uu          , Uu^Uf       , Uu^Uf       , Uu          , Kud         , Uu          , Uu^Uf       , Uu^Uf       , Uu          , Kud         , Cud         , Cud         , Cud         , Cud         , Uu          , Uu          , Xu          , Xu          , Xu          , Ql          , Ql          
Ql          , Ql          , Xu          , Xu          , Xu          , Uu^Uf       , Uu          , 5 Kud       , Cud         , Cud         , Cud         , Cud         , Uu          , Uu^Uf       , Uu          , Uu          , Uh          , Uu          , Uu          , Uu^Uf       , Uu          , Cud         , Cud         , Cud         , Cud         , 3 Kud       , Uu          , Uu^Uf       , Xu          , Xu          , Xu          , Ql          , Ql          
Ql          , Ql          , Xu          , Xu          , Xu          , Uu^Vud      , Uu^Uf       , Uu          , Uu^Vud      , Cud         , Uu          , Uu          , Uu^Vu       , Uu          , Cud         , Kud         , Uh          , Kud         , Cud         , Uu          , Uu^Vu       , Uu          , Uu          , Cud         , Uu^Vud      , Uu          , Uu^Uf       , Uu^Vud      , Xu          , Xu          , Xu          , Ql          , Ql          
Ql          , Ql          , Xu          , Xu          , Xu          , Xu          , Xu          , Uu          , Uh          , Uh          , Kud         , Cud         , Cud         , Uu          , Cud         , Cud         , Cud         , Cud         , Cud         , Uu          , Cud         , Cud         , Kud         , Uh          , Uh          , Uu          , Xu          , Xu          , Xu          , Xu          , Xu          , Ql          , Ql          
Ql          , Ql          , Ql          , Xu          , Xu          , Xu          , Xu          , Xu          , Xu          , Uh          , Xu          , Uh          , Kud         , Uu          , Cud         , Cud         , Cud         , Cud         , Cud         , Uu          , Kud         , Uh          , Xu          , Uh          , Xu          , Xu          , Xu          , Xu          , Xu          , Xu          , Ql          , Ql          , Ql          
Ql          , Ql          , Ql          , Ql          , Ql          , Xu          , Xu          , Xu          , Xu          , Xu          , Xu          , Xu          , Uh          , Uh          , Uu^Vud      , Cud         , 4 Kud       , Cud         , Uu^Vud      , Uh          , Uh          , Xu          , Xu          , Xu          , Xu          , Xu          , Xu          , Xu          , Ql          , Ql          , Ql          , Ql          , Ql          
Ql          , Ql          , Ql          , Ql          , Ql          , Ql          , Ql          , Xu          , Xu          , Xu          , Xu          , Xu          , Xu          , Uh          , Uu          , Uu          , Uu          , Uu          , Uu          , Uh          , Xu          , Xu          , Xu          , Xu          , Xu          , Xu          , Ql          , Ql          , Ql          , Ql          , Ql          , Ql          , Ql          
Ql          , Ql          , Ql          , Ql          , Ql          , Ql          , Ql          , Ql          , Ql          , Xu          , Xu          , Xu          , Xu          , Xu          , Xu          , Uu^Uf       , Uu^Vud      , Uu^Uf       , Xu          , Xu          , Xu          , Xu          , Xu          , Xu          , Ql          , Ql          , Ql          , Ql          , Ql          , Ql          , Ql          , Ql          , Ql          
Ql          , Ql          , Ql          , Ql          , Ql          , Ql          , Ql          , Ql          , Ql          , Ql          , Ql          , Xu          , Xu          , Xu          , Xu          , Xu          , Xu          , Xu          , Xu          , Xu          , Xu          , Xu          , Ql          , Ql          , Ql          , Ql          , Ql          , Ql          , Ql          , Ql          , Ql          , Ql          , Ql          
Ql          , Ql          , Ql          , Ql          , Ql          , Ql          , Ql          , Ql          , Ql          , Ql          , Ql          , Ql          , Ql          , Xu          , Xu          , Xu          , Xu          , Xu          , Xu          , Xu          , Ql          , Ql          , Ql          , Ql          , Ql          , Ql          , Ql          , Ql          , Ql          , Ql          , Ql          , Ql          , Ql          
Ql          , Ql          , Ql          , Ql          , Ql          , Ql          , Ql          , Ql          , Ql          , Ql          , Ql          , Ql          , Ql          , Ql          , Ql          , Xu          , Xu          , Xu          , Ql          , Ql          , Ql          , Ql          , Ql          , Ql          , Ql          , Ql          , Ql          , Ql          , Ql          , Ql          , Ql          , Ql          , Ql          
Ql          , Ql          , Ql          , Ql          , Ql          , Ql          , Ql          , Ql          , Ql          , Ql          , Ql          , Ql          , Ql          , Ql          , Ql          , Ql          , Ql          , Ql          , Ql          , Ql          , Ql          , Ql          , Ql          , Ql          , Ql          , Ql          , Ql          , Ql          , Ql          , Ql          , Ql          , Ql          , Ql          
Ql          , Ql          , Ql          , Ql          , Ql          , Ql          , Ql          , Ql          , Ql          , Ql          , Ql          , Ql          , Ql          , Ql          , Ql          , Ql          , Ql          , Ql          , Ql          , Ql          , Ql          , Ql          , Ql          , Ql          , Ql          , Ql          , Ql          , Ql          , Ql          , Ql          , Ql          , Ql          , Ql          
