border_size=1
usage=map

Ms, Ms, Ms, Ms, Ms, Ms, Ms, Ms, Ms, Ms, Ms, Ms, Ms, Ms, Ms, Ms, Ms, Ms, Ms, Ms, Ms, Ms, Ms, Ms, Ms, Ms, Ms, Ms, Ms, Ms, Ms, Ms, Ms
Ms, Ms, Ms, Ms, Ms, Ms, Ms, Ms, Ms, Ms, Ms, Ms, Ms, Ms, Ms, Ms, Ms, Ms, Ms, Ms, Ms, Ms, Ms, Ms, Ms, Ms, Ms, Ms, Ms, Ms, Ms, Ms, Ms
Ms, Ms, Ms, Ms, Ms, Ms, Ms, Ms, Ms, Ms, Ms, Ms, Ms, Ms, Ms, Ms, Ms^Xm, Ms, Ms, Ms, Ms, Ms, Ms, Ms, Ms, Ms, Ms, Ms, Ms, Ms, Ms, Ms, Ms
Ms, Ms, Ms, Ms, Ms, Ms, Ms, Ms, Ms, Ms, Ms, Ms, Ms, Ms, Ms^Xm, Ms^Xm, Ms^Xm, Ms^Xm, Ms^Xm, Ms, Ms, Ms, Ms, Ms, Ms, Ms, Ms, Ms, Ms, Ms, Ms, Ms, Ms
Ms, Ms, Ms, Ms, Ms, Ms, Ms, Ms, Ms, Ms, Ms, Ms, Ms^Xm, Ms^Xm, Ms^Xm, Ms^Xm, Ms^Xm, Ms^Xm, Ms^Xm, Ms^Xm, Ms^Xm, Ms, Ms, Ms, Ms, Ms, Ms, Ms, Ms, Ms, Ms, Ms, Ms
Ms, Ms, Ms, Ms, Ms, Ms, Ms, Ms, Ms, Ms, Ms^Xm, Ms^Xm, Ms^Xm, Ms^Xm, Ms^Xm, Ms^Xm, Ha^Vhha, Ms^Xm, Ms^Xm, Ms^Xm, Ms^Xm, Ms^Xm, Ms^Xm, Ms, Ms, Ms, Ms, Ms, Ms, Ms, Ms, Ms, Ms
Ms, Ms, Ms, Ms, Ms, Ms, Ms, Ms, Ms^Xm, Ms^Xm, Ms^Xm, Ms^Xm, Ms^Xm, Ms^Xm, Aa, Aa^Fpa, Aa, Aa^Fpa, Aa, Ms^Xm, Ms^Xm, Ms^Xm, Ms^Xm, Ms^Xm, Ms^Xm, Ms, Ms, Ms, Ms, Ms, Ms, Ms, Ms
Ms, Ms, Ms, Ms, Ms, Ms, Ms^Xm, Ms^Xm, Ms^Xm, Ms^Xm, Ms^Xm, Ms^Xm, Aa, Aa, Aa^Vhca, Aa, 1 Kh, Aa, Aa^Vhca, Aa, Aa, Ms^Xm, Ms^Xm, Ms^Xm, Ms^Xm, Ms^Xm, Ms^Xm, Ms, Ms, Ms, Ms, Ms, Ms
Ms, Ms, Ms, Ms, Ms^Xm, Ms^Xm, Ms^Xm, Ms^Xm, Ms^Xm, Ms^Xm, Ms^Xm, Ms^Xm, Ke, Aa, Chr, Chr, Chr, Chr, Chr, Aa, Ke, Ms^Xm, Ms^Xm, Ms^Xm, Ms^Xm, Ms^Xm, Ms^Xm, Ms^Xm, Ms^Xm, Ms, Ms, Ms, Ms
Ms, Ms, Ms^Xm, Ms^Xm, Ms^Xm, Ms^Xm, Ms^Xm, Ms^Xm, Aa, Aa, Ke, Ms, Ce, Ha, Chr, Chr, Chr, Chr, Chr, Ha, Ce, Ms, Ke, Aa, Aa, Ms^Xm, Ms^Xm, Ms^Xm, Ms^Xm, Ms^Xm, Ms^Xm, Ms, Ms
Ms, Ms, Ms^Xm, Ms^Xm, Ms^Xm, Ms^Xm, Aa^Fpa, Aa, Aa^Vhca, Aa, Ha, Ce, Aa^Vha, Ha, Chr, Chr, Ha, Chr, Chr, Ha, Aa^Vha, Ce, Ha, Aa, Aa^Vhca, Aa, Aa^Fpa, Ms^Xm, Ms^Xm, Ms^Xm, Ms^Xm, Ms, Ms
Ms, Ms, Ms^Xm, Ms^Xm, Ms^Xm, Ha^Vhha, Aa, Aa, Chr, Chr, Chr, Ha, Aa, Aa, Aa, Kh, Ha, Kh, Aa, Aa, Aa, Ha, Chr, Chr, Chr, Aa, Aa, Ha^Vhha, Ms^Xm, Ms^Xm, Ms^Xm, Ms, Ms
Ms, Ms, Ms^Xm, Ms^Xm, Ms^Xm, Aa^Fpa, Aa, 6 Kh, Chr, Chr, Chr, Chr, Aa, Aa^Fpa, Aa^Fpa, Aa, Khr, Aa, Aa^Fda, Aa^Fda, Aa, Chr, Chr, Chr, Chr, 2 Kh, Aa, Aa^Fpa, Ms^Xm, Ms^Xm, Ms^Xm, Ms, Ms
Ms, Ms, Ms^Xm, Ms^Xm, Ms^Xm, Aa, Aa^Vhca, Chr, Chr, Chr, Ha, Kh, Aa, Aa^Fpa, Aa^Vea, Aa, Chw, Aa, Aa^Vea, Aa^Fda, Aa, Kh, Ha, Chr, Chr, Chr, Aa^Vhca, Aa, Ms^Xm, Ms^Xm, Ms^Xm, Ms, Ms
Ms, Ms, Ms^Xm, Ms^Xm, Ms^Xm, Aa, Aa, Chr, Chr, Chr, Kh, Ha, Khr, Aa, Chw, Chw, Ai, Chw, Chw, Aa, Khr, Ha, Kh, Chr, Chr, Chr, Aa, Aa, Ms^Xm, Ms^Xm, Ms^Xm, Ms, Ms
Ms, Ms, Ms^Xm, Ms^Xm, Ms^Xm, Aa, Ke, Ha, Ha, Chr, Aa, Aa, Aa, Chw, Ai, Ai, Ai, Ai, Ai, Chw, Aa, Aa, Aa, Chr, Ha, Ha, Ke, Aa, Ms^Xm, Ms^Xm, Ms^Xm, Ms, Ms
Ms, Ms, Ms^Xm, Ms^Xm, Ms^Xm, Ms^Xm, Ms, Ce, Aa^Vha, Aa, Aa^Fma, Aa^Fma, Aa^Vea, Chw, Ai, Ai, Ha^Vhha, Ai, Ai, Chw, Aa^Vea, Aa^Fma, Aa^Fma, Aa, Aa^Vha, Ce, Ms, Ms^Xm, Ms^Xm, Ms^Xm, Ms^Xm, Ms, Ms
Ms, Ms, Ms^Xm, Ms^Xm, Ms^Xm, Ms^Xm, Ke, Ce, Ha, Aa, Aa, Aa^Fma, Aa, Chw, Ai, Ai, Ai, Ai, Ai, Chw, Aa, Aa^Fma, Aa, Aa, Ha, Ce, Ke, Ms^Xm, Ms^Xm, Ms^Xm, Ms^Xm, Ms, Ms
Ms, Ms, Ms^Xm, Ms^Xm, Ms^Xm, Aa, Aa, Ha, Chr, Chr, Kh, Aa, Khr, Chw, Chw, Ai, Ai, Ai, Chw, Chw, Khr, Aa, Kh, Chr, Chr, Ha, Aa, Aa, Ms^Xm, Ms^Xm, Ms^Xm, Ms, Ms
Ms, Ms, Ms^Xm, Ms^Xm, Ms^Xm, Aa, Aa^Vhca, Chr, Chr, Chr, Ha, Ha, Aa, Aa, Aa^Vea, Chw, Chw, Chw, Aa^Vea, Aa, Aa, Ha, Ha, Chr, Chr, Chr, Aa^Vhca, Aa, Ms^Xm, Ms^Xm, Ms^Xm, Ms, Ms
Ms, Ms, Ms^Xm, Ms^Xm, Ms^Xm, Aa, Aa, Chr, Chr, Chr, Chr, Kh, Aa, Aa^Fda, Aa^Fda, Aa, Khr, Aa, Aa^Fpa, Aa^Fpa, Aa, Kh, Chr, Chr, Chr, Chr, Aa, Aa, Ms^Xm, Ms^Xm, Ms^Xm, Ms, Ms
Ms, Ms, Ms^Xm, Ms^Xm, Ms^Xm, Aa^Fpa, Aa, 5 Kh, Chr, Chr, Chr, Chr, Aa, Aa^Fda, Aa, Aa, Ha, Aa, Aa, Aa^Fpa, Aa, Chr, Chr, Chr, Chr, 3 Kh, Aa, Aa^Fpa, Ms^Xm, Ms^Xm, Ms^Xm, Ms, Ms
Ms, Ms, Ms^Xm, Ms^Xm, Ms^Xm, Ha^Vhha, Aa^Fpa, Aa, Aa^Vhca, Chr, Ha, Ha, Aa^Vha, Aa, Chr, Kh, Ha, Kh, Chr, Aa, Aa^Vha, Ha, Ha, Chr, Aa^Vhca, Aa, Aa^Fpa, Ha^Vhha, Ms^Xm, Ms^Xm, Ms^Xm, Ms, Ms
Ms, Ms, Ms^Xm, Ms^Xm, Ms^Xm, Ms^Xm, Ms^Xm, Aa, Aa, Aa, Ke, Ce, Ce, Ha, Chr, Chr, Chr, Chr, Chr, Ha, Ce, Ce, Ke, Aa, Aa, Aa, Ms^Xm, Ms^Xm, Ms^Xm, Ms^Xm, Ms^Xm, Ms, Ms
Ms, Ms, Ms, Ms^Xm, Ms^Xm, Ms^Xm, Ms^Xm, Ms^Xm, Ms^Xm, Aa, Ms^Xm, Ms, Ke, Ha, Chr, Chr, Chr, Chr, Chr, Ha, Ke, Ms, Ms^Xm, Aa, Ms^Xm, Ms^Xm, Ms^Xm, Ms^Xm, Ms^Xm, Ms^Xm, Ms, Ms, Ms
Ms, Ms, Ms, Ms, Ms, Ms^Xm, Ms^Xm, Ms^Xm, Ms^Xm, Ms^Xm, Ms^Xm, Ms^Xm, Aa, Aa, Aa^Vhca, Chr, 4 Kh, Chr, Aa^Vhca, Aa, Aa, Ms^Xm, Ms^Xm, Ms^Xm, Ms^Xm, Ms^Xm, Ms^Xm, Ms^Xm, Ms, Ms, Ms, Ms, Ms
Ms, Ms, Ms, Ms, Ms, Ms, Ms, Ms^Xm, Ms^Xm, Ms^Xm, Ms^Xm, Ms^Xm, Ms^Xm, Aa, Aa, Aa, Aa, Aa, Aa, Aa, Ms^Xm, Ms^Xm, Ms^Xm, Ms^Xm, Ms^Xm, Ms^Xm, Ms, Ms, Ms, Ms, Ms, Ms, Ms
Ms, Ms, Ms, Ms, Ms, Ms, Ms, Ms, Ms, Ms^Xm, Ms^Xm, Ms^Xm, Ms^Xm, Ms^Xm, Ms^Xm, Aa^Fpa, Ha^Vhha, Aa^Fpa, Ms^Xm, Ms^Xm, Ms^Xm, Ms^Xm, Ms^Xm, Ms^Xm, Ms, Ms, Ms, Ms, Ms, Ms, Ms, Ms, Ms
Ms, Ms, Ms, Ms, Ms, Ms, Ms, Ms, Ms, Ms, Ms, Ms^Xm, Ms^Xm, Ms^Xm, Ms^Xm, Ms^Xm, Ms^Xm, Ms^Xm, Ms^Xm, Ms^Xm, Ms^Xm, Ms^Xm, Ms, Ms, Ms, Ms, Ms, Ms, Ms, Ms, Ms, Ms, Ms
Ms, Ms, Ms, Ms, Ms, Ms, Ms, Ms, Ms, Ms, Ms, Ms, Ms, Ms^Xm, Ms^Xm, Ms^Xm, Ms^Xm, Ms^Xm, Ms^Xm, Ms^Xm, Ms, Ms, Ms, Ms, Ms, Ms, Ms, Ms, Ms, Ms, Ms, Ms, Ms
Ms, Ms, Ms, Ms, Ms, Ms, Ms, Ms, Ms, Ms, Ms, Ms, Ms, Ms, Ms, Ms^Xm, Ms^Xm, Ms^Xm, Ms, Ms, Ms, Ms, Ms, Ms, Ms, Ms, Ms, Ms, Ms, Ms, Ms, Ms, Ms
Ms, Ms, Ms, Ms, Ms, Ms, Ms, Ms, Ms, Ms, Ms, Ms, Ms, Ms, Ms, Ms, Ms, Ms, Ms, Ms, Ms, Ms, Ms, Ms, Ms, Ms, Ms, Ms, Ms, Ms, Ms, Ms, Ms
Ms, Ms, Ms, Ms, Ms, Ms, Ms, Ms, Ms, Ms, Ms, Ms, Ms, Ms, Ms, Ms, Ms, Ms, Ms, Ms, Ms, Ms, Ms, Ms, Ms, Ms, Ms, Ms, Ms, Ms, Ms, Ms, Ms
