border_size=1
usage=map

Gs^Fp, Gs^Fp, Gs^Fp, Gs^Fp, Gs^Fp, Gs^Fp, Gs^Fp, Gs^Fp, Gs^Fp, Gs^Fp, Gs^Fp, Gs^Fp, Gs^Fp, Gs^Fp, Gs^Fp, Gs^Fp, Gs^Fp, Gs^Fp, Gs^Fp, Gs^Fp, Gs^Fp, Gs^Fp, Gs^Fp, Gs^Fp, Gs^Fp, Gs^Fp, Gs^Fp, Gs^Fp, Gs^Fp, Gs^Fp, Gs^Fp, Gs^Fp, Gs^Fp
Gs^Fp, Gs^Fp, Gs^Fp, Gs^Fp, Gs^Fp, Gs^Fp, Gs^Fp, Gs^Fp, Gs^Fp, Gs^Fp, Gs^Fp, Gs^Fp, Gs^Fp, Gs^Fp, Gs^Fp, Gs^Fp, Gs^Fp, Gs^Fp, Gs^Fp, Gs^Fp, Gs^Fp, Gs^Fp, Gs^Fp, Gs^Fp, Gs^Fp, Gs^Fp, Gs^Fp, Gs^Fp, Gs^Fp, Gs^Fp, Gs^Fp, Gs^Fp, Gs^Fp
Gs^Fp, Gs^Fp, Gs^Fp, Gs^Fp, Gs^Fp, Gs^Fp, Gs^Fp, Gs^Fp, Gs^Fp, Gs^Fp, Gs^Fp, Gs^Fp, Gs^Fp, Gs^Fp, Gs^Fp, Gs^Fp, Mm^Xm, Gs^Fp, Gs^Fp, Gs^Fp, Gs^Fp, Gs^Fp, Gs^Fp, Gs^Fp, Gs^Fp, Gs^Fp, Gs^Fp, Gs^Fp, Gs^Fp, Gs^Fp, Gs^Fp, Gs^Fp, Gs^Fp
Gs^Fp, Gs^Fp, Gs^Fp, Gs^Fp, Gs^Fp, Gs^Fp, Gs^Fp, Gs^Fp, Gs^Fp, Gs^Fp, Gs^Fp, Gs^Fp, Gs^Fp, Gs^Fp, Mm^Xm, Mm^Xm, Mm^Xm, Mm^Xm, Mm^Xm, Gs^Fp, Gs^Fp, Gs^Fp, Gs^Fp, Gs^Fp, Gs^Fp, Gs^Fp, Gs^Fp, Gs^Fp, Gs^Fp, Gs^Fp, Gs^Fp, Gs^Fp, Gs^Fp
Gs^Fp, Gs^Fp, Gs^Fp, Gs^Fp, Gs^Fp, Gs^Fp, Gs^Fp, Gs^Fp, Gs^Fp, Gs^Fp, Gs^Fp, Gs^Fp, Mm^Xm, Mm^Xm, Mm^Xm, Mm^Xm, Mm^Xm, Mm^Xm, Mm^Xm, Mm^Xm, Mm^Xm, Gs^Fp, Gs^Fp, Gs^Fp, Gs^Fp, Gs^Fp, Gs^Fp, Gs^Fp, Gs^Fp, Gs^Fp, Gs^Fp, Gs^Fp, Gs^Fp
Gs^Fp, Gs^Fp, Gs^Fp, Gs^Fp, Gs^Fp, Gs^Fp, Gs^Fp, Gs^Fp, Gs^Fp, Gs^Fp, Mm^Xm, Mm^Xm, Mm^Xm, Mm^Xm, Mm^Xm, Mm^Xm, Gg^Ve, Mm^Xm, Mm^Xm, Mm^Xm, Mm^Xm, Mm^Xm, Mm^Xm, Gs^Fp, Gs^Fp, Gs^Fp, Gs^Fp, Gs^Fp, Gs^Fp, Gs^Fp, Gs^Fp, Gs^Fp, Gs^Fp
Gs^Fp, Gs^Fp, Gs^Fp, Gs^Fp, Gs^Fp, Gs^Fp, Gs^Fp, Gs^Fp, Mm^Xm, Mm^Xm, Mm^Xm, Mm^Xm, Mm^Xm, Mm^Xm, Gs^Fds, Hh^Fp, Gs^Fds, Hh^Fp, Gs^Fds, Mm^Xm, Mm^Xm, Mm^Xm, Mm^Xm, Mm^Xm, Mm^Xm, Gs^Fp, Gs^Fp, Gs^Fp, Gs^Fp, Gs^Fp, Gs^Fp, Gs^Fp, Gs^Fp
Gs^Fp, Gs^Fp, Gs^Fp, Gs^Fp, Gs^Fp, Gs^Fp, Mm^Xm, Mm^Xm, Mm^Xm, Mm^Xm, Mm^Xm, Mm^Xm, Gs^Fds, Gs^Fds, Gg^Ve, Gs^Fds, 1 Kv, Gs^Fds, Gg^Ve, Gs^Fds, Gs^Fds, Mm^Xm, Mm^Xm, Mm^Xm, Mm^Xm, Mm^Xm, Mm^Xm, Gs^Fp, Gs^Fp, Gs^Fp, Gs^Fp, Gs^Fp, Gs^Fp
Gs^Fp, Gs^Fp, Gs^Fp, Gs^Fp, Mm^Xm, Mm^Xm, Mm^Xm, Mm^Xm, Mm^Xm, Mm^Xm, Mm^Xm, Mm^Xm, Ke, Gs^Fds, Cv, Cv, Cv, Cv, Cv, Gs^Fds, Ke, Mm^Xm, Mm^Xm, Mm^Xm, Mm^Xm, Mm^Xm, Mm^Xm, Mm^Xm, Mm^Xm, Gs^Fp, Gs^Fp, Gs^Fp, Gs^Fp
Gs^Fp, Gs^Fp, Mm^Xm, Mm^Xm, Mm^Xm, Mm^Xm, Mm^Xm, Mm^Xm, Gs^Fds, Gs^Fds, Ke, Hh^Fp, Ce, Gs^Fds, Cv, Cv, Cv, Cv, Cv, Gs^Fds, Ce, Hh^Fp, Ke, Gs^Fds, Gs^Fds, Mm^Xm, Mm^Xm, Mm^Xm, Mm^Xm, Mm^Xm, Mm^Xm, Gs^Fp, Gs^Fp
Gs^Fp, Gs^Fp, Mm^Xm, Mm^Xm, Mm^Xm, Mm^Xm, Hh^Fp, Gs^Fds, Gg^Ve, Gs^Fds, Gs^Fds, Ce, Gg^Vl, Gs^Fms, Cv, Cv, Gs^Fms, Cv, Cv, Gs^Fms, Gg^Vl, Ce, Gs^Fds, Gs^Fds, Gg^Ve, Gs^Fds, Hh^Fp, Mm^Xm, Mm^Xm, Mm^Xm, Mm^Xm, Gs^Fp, Gs^Fp
Gs^Fp, Gs^Fp, Mm^Xm, Mm^Xm, Mm^Xm, Gg^Ve, Gs^Fds, Gs^Fds, Cv, Cv, Cv, Gs^Fms, Gs^Fms, Gs^Fms, Gs^Fms, Kv, Gs^Fms, Kv, Gs^Fms, Gs^Fms, Gs^Fms, Gs^Fms, Cv, Cv, Cv, Gs^Fds, Gs^Fds, Gg^Ve, Mm^Xm, Mm^Xm, Mm^Xm, Gs^Fp, Gs^Fp
Gs^Fp, Gs^Fp, Mm^Xm, Mm^Xm, Mm^Xm, Hh^Fp, Gs^Fds, 6 Kv, Cv, Cv, Cv, Cv, Gs^Fms, Hh^Fp, Hh^Fp, Gs^Fms, Kv, Gs^Fms, Hh^Fp, Hh^Fp, Gs^Fms, Cv, Cv, Cv, Cv, 2 Kv, Gs^Fds, Hh^Fp, Mm^Xm, Mm^Xm, Mm^Xm, Gs^Fp, Gs^Fp
Gs^Fp, Gs^Fp, Mm^Xm, Mm^Xm, Mm^Xm, Gs^Fds, Gg^Ve, Cv, Cv, Cv, Gs^Fms, Kv, Gs^Fms, Hh^Fp, Gg^Ve, Gs^Fms, Cv, Gs^Fms, Gg^Ve, Hh^Fp, Gs^Fms, Kv, Gs^Fms, Cv, Cv, Cv, Gg^Ve, Gs^Fds, Mm^Xm, Mm^Xm, Mm^Xm, Gs^Fp, Gs^Fp
Gs^Fp, Gs^Fp, Mm^Xm, Mm^Xm, Mm^Xm, Gs^Fds, Gs^Fds, Cv, Cv, Cv, Kv, Gs^Fms, Kv, Gs^Fms, Cv, Cv, Hh^Fp, Cv, Cv, Gs^Fms, Kv, Gs^Fms, Kv, Cv, Cv, Cv, Gs^Fds, Gs^Fds, Mm^Xm, Mm^Xm, Mm^Xm, Gs^Fp, Gs^Fp
Gs^Fp, Gs^Fp, Mm^Xm, Mm^Xm, Mm^Xm, Gs^Fds, Ke, Gs^Fds, Gs^Fms, Cv, Gs^Fms, Gs^Fms, Gs^Fms, Cv, Hh^Fp, Gs^Fp, Gs^Fp, Gs^Fp, Hh^Fp, Cv, Gs^Fms, Gs^Fms, Gs^Fms, Cv, Gs^Fms, Gs^Fds, Ke, Gs^Fds, Mm^Xm, Mm^Xm, Mm^Xm, Gs^Fp, Gs^Fp
Gs^Fp, Gs^Fp, Mm^Xm, Mm^Xm, Mm^Xm, Mm^Xm, Hh^Fp, Ce, Gg^Vl, Gs^Fms, Hh^Fp, Hh^Fp, Gg^Ve, Cv, Gs^Fp, Hh^Fp, Gg^Ve, Hh^Fp, Gs^Fp, Cv, Gg^Ve, Hh^Fp, Hh^Fp, Gs^Fms, Gg^Vl, Ce, Hh^Fp, Mm^Xm, Mm^Xm, Mm^Xm, Mm^Xm, Gs^Fp, Gs^Fp
Gs^Fp, Gs^Fp, Mm^Xm, Mm^Xm, Mm^Xm, Mm^Xm, Ke, Ce, Gs^Fms, Gs^Fms, Gs^Fms, Hh^Fp, Gs^Fms, Cv, Hh^Fp, Gs^Fp, Hh^Fp, Gs^Fp, Hh^Fp, Cv, Gs^Fms, Hh^Fp, Gs^Fms, Gs^Fms, Gs^Fms, Ce, Ke, Mm^Xm, Mm^Xm, Mm^Xm, Mm^Xm, Gs^Fp, Gs^Fp
Gs^Fp, Gs^Fp, Mm^Xm, Mm^Xm, Mm^Xm, Gs^Fds, Gs^Fds, Gs^Fds, Cv, Cv, Kv, Gs^Fms, Kv, Cv, Cv, Gs^Fp, Hh^Fp, Gs^Fp, Cv, Cv, Kv, Gs^Fms, Kv, Cv, Cv, Gs^Fds, Gs^Fds, Gs^Fds, Mm^Xm, Mm^Xm, Mm^Xm, Gs^Fp, Gs^Fp
Gs^Fp, Gs^Fp, Mm^Xm, Mm^Xm, Mm^Xm, Gs^Fds, Gg^Ve, Cv, Cv, Cv, Gs^Fms, Gs^Fms, Gs^Fms, Gs^Fms, Gg^Ve, Cv, Cv, Cv, Gg^Ve, Gs^Fms, Gs^Fms, Gs^Fms, Gs^Fms, Cv, Cv, Cv, Gg^Ve, Gs^Fds, Mm^Xm, Mm^Xm, Mm^Xm, Gs^Fp, Gs^Fp
Gs^Fp, Gs^Fp, Mm^Xm, Mm^Xm, Mm^Xm, Gs^Fds, Gs^Fds, Cv, Cv, Cv, Cv, Kv, Gs^Fms, Hh^Fp, Hh^Fp, Gs^Fms, Kv, Gs^Fms, Hh^Fp, Hh^Fp, Gs^Fms, Kv, Cv, Cv, Cv, Cv, Gs^Fds, Gs^Fds, Mm^Xm, Mm^Xm, Mm^Xm, Gs^Fp, Gs^Fp
Gs^Fp, Gs^Fp, Mm^Xm, Mm^Xm, Mm^Xm, Hh^Fp, Gs^Fds, 5 Kv, Cv, Cv, Cv, Cv, Gs^Fms, Hh^Fp, Gs^Fms, Gs^Fms, Gs^Fms, Gs^Fms, Gs^Fms, Hh^Fp, Gs^Fms, Cv, Cv, Cv, Cv, 3 Kv, Gs^Fds, Hh^Fp, Mm^Xm, Mm^Xm, Mm^Xm, Gs^Fp, Gs^Fp
Gs^Fp, Gs^Fp, Mm^Xm, Mm^Xm, Mm^Xm, Gg^Ve, Hh^Fp, Gs^Fds, Gg^Ve, Cv, Gs^Fds, Gs^Fms, Gg^Vl, Gs^Fms, Cv, Kv, Gs^Fms, Kv, Cv, Gs^Fms, Gg^Vl, Gs^Fms, Gs^Fds, Cv, Gg^Ve, Gs^Fds, Hh^Fp, Gg^Ve, Mm^Xm, Mm^Xm, Mm^Xm, Gs^Fp, Gs^Fp
Gs^Fp, Gs^Fp, Mm^Xm, Mm^Xm, Mm^Xm, Mm^Xm, Mm^Xm, Gs^Fds, Gs^Fds, Gs^Fds, Ke, Ce, Ce, Gs^Fms, Cv, Cv, Cv, Cv, Cv, Gs^Fms, Ce, Ce, Ke, Gs^Fds, Gs^Fds, Gs^Fds, Mm^Xm, Mm^Xm, Mm^Xm, Mm^Xm, Mm^Xm, Gs^Fp, Gs^Fp
Gs^Fp, Gs^Fp, Gs^Fp, Mm^Xm, Mm^Xm, Mm^Xm, Mm^Xm, Mm^Xm, Mm^Xm, Gs^Fds, Mm^Xm, Hh^Fp, Ke, Gs^Fds, Cv, Cv, Cv, Cv, Cv, Gs^Fds, Ke, Hh^Fp, Mm^Xm, Gs^Fds, Mm^Xm, Mm^Xm, Mm^Xm, Mm^Xm, Mm^Xm, Mm^Xm, Gs^Fp, Gs^Fp, Gs^Fp
Gs^Fp, Gs^Fp, Gs^Fp, Gs^Fp, Gs^Fp, Mm^Xm, Mm^Xm, Mm^Xm, Mm^Xm, Mm^Xm, Mm^Xm, Mm^Xm, Gs^Fds, Gs^Fds, Gg^Ve, Cv, 4 Kv, Cv, Gg^Ve, Gs^Fds, Gs^Fds, Mm^Xm, Mm^Xm, Mm^Xm, Mm^Xm, Mm^Xm, Mm^Xm, Mm^Xm, Gs^Fp, Gs^Fp, Gs^Fp, Gs^Fp, Gs^Fp
Gs^Fp, Gs^Fp, Gs^Fp, Gs^Fp, Gs^Fp, Gs^Fp, Gs^Fp, Mm^Xm, Mm^Xm, Mm^Xm, Mm^Xm, Mm^Xm, Mm^Xm, Gs^Fds, Gs^Fds, Gs^Fds, Gs^Fds, Gs^Fds, Gs^Fds, Gs^Fds, Mm^Xm, Mm^Xm, Mm^Xm, Mm^Xm, Mm^Xm, Mm^Xm, Gs^Fp, Gs^Fp, Gs^Fp, Gs^Fp, Gs^Fp, Gs^Fp, Gs^Fp
Gs^Fp, Gs^Fp, Gs^Fp, Gs^Fp, Gs^Fp, Gs^Fp, Gs^Fp, Gs^Fp, Gs^Fp, Mm^Xm, Mm^Xm, Mm^Xm, Mm^Xm, Mm^Xm, Mm^Xm, Hh^Fp, Gg^Ve, Hh^Fp, Mm^Xm, Mm^Xm, Mm^Xm, Mm^Xm, Mm^Xm, Mm^Xm, Gs^Fp, Gs^Fp, Gs^Fp, Gs^Fp, Gs^Fp, Gs^Fp, Gs^Fp, Gs^Fp, Gs^Fp
Gs^Fp, Gs^Fp, Gs^Fp, Gs^Fp, Gs^Fp, Gs^Fp, Gs^Fp, Gs^Fp, Gs^Fp, Gs^Fp, Gs^Fp, Mm^Xm, Mm^Xm, Mm^Xm, Mm^Xm, Mm^Xm, Mm^Xm, Mm^Xm, Mm^Xm, Mm^Xm, Mm^Xm, Mm^Xm, Gs^Fp, Gs^Fp, Gs^Fp, Gs^Fp, Gs^Fp, Gs^Fp, Gs^Fp, Gs^Fp, Gs^Fp, Gs^Fp, Gs^Fp
Gs^Fp, Gs^Fp, Gs^Fp, Gs^Fp, Gs^Fp, Gs^Fp, Gs^Fp, Gs^Fp, Gs^Fp, Gs^Fp, Gs^Fp, Gs^Fp, Gs^Fp, Mm^Xm, Mm^Xm, Mm^Xm, Mm^Xm, Mm^Xm, Mm^Xm, Mm^Xm, Gs^Fp, Gs^Fp, Gs^Fp, Gs^Fp, Gs^Fp, Gs^Fp, Gs^Fp, Gs^Fp, Gs^Fp, Gs^Fp, Gs^Fp, Gs^Fp, Gs^Fp
Gs^Fp, Gs^Fp, Gs^Fp, Gs^Fp, Gs^Fp, Gs^Fp, Gs^Fp, Gs^Fp, Gs^Fp, Gs^Fp, Gs^Fp, Gs^Fp, Gs^Fp, Gs^Fp, Gs^Fp, Mm^Xm, Mm^Xm, Mm^Xm, Gs^Fp, Gs^Fp, Gs^Fp, Gs^Fp, Gs^Fp, Gs^Fp, Gs^Fp, Gs^Fp, Gs^Fp, Gs^Fp, Gs^Fp, Gs^Fp, Gs^Fp, Gs^Fp, Gs^Fp
Gs^Fp, Gs^Fp, Gs^Fp, Gs^Fp, Gs^Fp, Gs^Fp, Gs^Fp, Gs^Fp, Gs^Fp, Gs^Fp, Gs^Fp, Gs^Fp, Gs^Fp, Gs^Fp, Gs^Fp, Gs^Fp, Gs^Fp, Gs^Fp, Gs^Fp, Gs^Fp, Gs^Fp, Gs^Fp, Gs^Fp, Gs^Fp, Gs^Fp, Gs^Fp, Gs^Fp, Gs^Fp, Gs^Fp, Gs^Fp, Gs^Fp, Gs^Fp, Gs^Fp
Gs^Fp, Gs^Fp, Gs^Fp, Gs^Fp, Gs^Fp, Gs^Fp, Gs^Fp, Gs^Fp, Gs^Fp, Gs^Fp, Gs^Fp, Gs^Fp, Gs^Fp, Gs^Fp, Gs^Fp, Gs^Fp, Gs^Fp, Gs^Fp, Gs^Fp, Gs^Fp, Gs^Fp, Gs^Fp, Gs^Fp, Gs^Fp, Gs^Fp, Gs^Fp, Gs^Fp, Gs^Fp, Gs^Fp, Gs^Fp, Gs^Fp, Gs^Fp, Gs^Fp
