border_size=1
usage=map

Hd          , Hd          , Hd          , Hd          , Hd          , Hd          , Hd          , Hd          , Hd          , Hd          , Hd          , Hd          , Hd          , Hd          , Hd          , Hd          , Hd          , Hd          , Hd          , Hd          , Hd          , Hd          , Hd          , Hd          , Hd          , Hd          , Hd          , Hd          , Hd          , Hd          , Hd          , Hd          , Hd          
Hd          , Hd          , Hd          , Hd          , Hd          , Hd          , Hd          , Hd          , Hd          , Hd          , Hd          , Hd          , Hd          , Hd          , Hd          , Hd          , Hd          , Hd          , Hd          , Hd          , Hd          , Hd          , Hd          , Hd          , Hd          , Hd          , Hd          , Hd          , Hd          , Hd          , Hd          , Hd          , Hd          
Hd          , Hd          , Hd          , Hd          , Hd          , Hd          , Hd          , Hd          , Hd          , Hd          , Hd          , Hd          , Hd          , Hd          , Hd          , Hd          , Md^Xm       , Hd          , Hd          , Hd          , Hd          , Hd          , Hd          , Hd          , Hd          , Hd          , Hd          , Hd          , Hd          , Hd          , Hd          , Hd          , Hd          
Hd          , Hd          , Hd          , Hd          , Hd          , Hd          , Hd          , Hd          , Hd          , Hd          , Hd          , Hd          , Hd          , Hd          , Md^Xm       , Md^Xm       , Md^Xm       , Md^Xm       , Md^Xm       , Hd          , Hd          , Hd          , Hd          , Hd          , Hd          , Hd          , Hd          , Hd          , Hd          , Hd          , Hd          , Hd          , Hd          
Hd          , Hd          , Hd          , Hd          , Hd          , Hd          , Hd          , Hd          , Hd          , Hd          , Hd          , Hd          , Md^Xm       , Md^Xm       , Md^Xm       , Md^Xm       , Md^Xm       , Md^Xm       , Md^Xm       , Md^Xm       , Md^Xm       , Hd          , Hd          , Hd          , Hd          , Hd          , Hd          , Hd          , Hd          , Hd          , Hd          , Hd          , Hd          
Hd          , Hd          , Hd          , Hd          , Hd          , Hd          , Hd          , Hd          , Hd          , Hd          , Md^Xm       , Md^Xm       , Md^Xm       , Md^Xm       , Md^Xm       , Md^Xm       , Dd^Vda      , Md^Xm       , Md^Xm       , Md^Xm       , Md^Xm       , Md^Xm       , Md^Xm       , Hd          , Hd          , Hd          , Hd          , Hd          , Hd          , Hd          , Hd          , Hd          , Hd          
Hd          , Hd          , Hd          , Hd          , Hd          , Hd          , Hd          , Hd          , Md^Xm       , Md^Xm       , Md^Xm       , Md^Xm       , Md^Xm       , Md^Xm       , Dd          , Gs^Ft       , Dd          , Gs^Ft       , Dd          , Md^Xm       , Md^Xm       , Md^Xm       , Md^Xm       , Md^Xm       , Md^Xm       , Hd          , Hd          , Hd          , Hd          , Hd          , Hd          , Hd          , Hd          
Hd          , Hd          , Hd          , Hd          , Hd          , Hd          , Md^Xm       , Md^Xm       , Md^Xm       , Md^Xm       , Md^Xm       , Md^Xm       , Dd          , Dd          , Dd^Vda      , Dd          , 1 Ke        , Dd          , Dd^Vda      , Dd          , Dd          , Md^Xm       , Md^Xm       , Md^Xm       , Md^Xm       , Md^Xm       , Md^Xm       , Hd          , Hd          , Hd          , Hd          , Hd          , Hd          
Hd          , Hd          , Hd          , Hd          , Md^Xm       , Md^Xm       , Md^Xm       , Md^Xm       , Md^Xm       , Md^Xm       , Md^Xm       , Md^Xm       , Ke          , Dd          , Ce          , Ce          , Ce          , Ce          , Ce          , Dd          , Ke          , Md^Xm       , Md^Xm       , Md^Xm       , Md^Xm       , Md^Xm       , Md^Xm       , Md^Xm       , Md^Xm       , Hd          , Hd          , Hd          , Hd          
Hd          , Hd          , Md^Xm       , Md^Xm       , Md^Xm       , Md^Xm       , Md^Xm       , Md^Xm       , Dd          , Dd          , Ke          , Md          , Ce          , Hd          , Ce          , Ce          , Ce          , Ce          , Ce          , Hd          , Ce          , Md          , Ke          , Dd          , Dd          , Md^Xm       , Md^Xm       , Md^Xm       , Md^Xm       , Md^Xm       , Md^Xm       , Hd          , Hd          
Hd          , Hd          , Md^Xm       , Md^Xm       , Md^Xm       , Md^Xm       , Gs^Ft       , Dd          , Dd^Vda      , Dd          , Hd          , Ce          , Dd^Vdt      , Hd          , Ce          , Ce          , Hd          , Ce          , Ce          , Hd          , Dd^Vdt      , Ce          , Hd          , Dd          , Dd^Vda      , Dd          , Gs^Ft       , Md^Xm       , Md^Xm       , Md^Xm       , Md^Xm       , Hd          , Hd          
Hd          , Hd          , Md^Xm       , Md^Xm       , Md^Xm       , Dd^Vda      , Dd          , Dd          , Ce          , Ce          , Ce          , Hd          , Dd          , Dd          , Dd          , Ke          , Hd          , Ke          , Dd          , Dd          , Dd          , Hd          , Ce          , Ce          , Ce          , Dd          , Dd          , Dd^Vda      , Md^Xm       , Md^Xm       , Md^Xm       , Hd          , Hd          
Hd          , Hd          , Md^Xm       , Md^Xm       , Md^Xm       , Gs^Ft       , Dd          , 6 Ke        , Ce          , Ce          , Ce          , Ce          , Dd          , Gs^Ft       , Gs^Ft       , Dd          , Ke          , Dd          , Gs^Ft       , Gs^Ft       , Dd          , Ce          , Ce          , Ce          , Ce          , 2 Ke        , Dd          , Gs^Ft       , Md^Xm       , Md^Xm       , Md^Xm       , Hd          , Hd          
Hd          , Hd          , Md^Xm       , Md^Xm       , Md^Xm       , Dd          , Dd^Vda      , Ce          , Ce          , Ce          , Hd          , Ke          , Dd          , Gs^Ft       , Dd^Vdt      , Dd          , Ce          , Dd          , Dd^Vdt      , Gs^Ft       , Dd          , Ke          , Hd          , Ce          , Ce          , Ce          , Dd^Vda      , Dd          , Md^Xm       , Md^Xm       , Md^Xm       , Hd          , Hd          
Hd          , Hd          , Md^Xm       , Md^Xm       , Md^Xm       , Dd          , Dd          , Ce          , Ce          , Ce          , Ke          , Hd          , Ke          , Dd          , Ce          , Ce          , Md          , Ce          , Ce          , Dd          , Ke          , Hd          , Ke          , Ce          , Ce          , Ce          , Dd          , Dd          , Md^Xm       , Md^Xm       , Md^Xm       , Hd          , Hd          
Hd          , Hd          , Md^Xm       , Md^Xm       , Md^Xm       , Dd          , Ke          , Hd          , Hd          , Ce          , Dd          , Dd          , Dd          , Ce          , Md          , Dd^Do       , Dd          , Dd^Do       , Md          , Ce          , Dd          , Dd          , Dd          , Ce          , Hd          , Hd          , Ke          , Dd          , Md^Xm       , Md^Xm       , Md^Xm       , Hd          , Hd          
Hd          , Hd          , Md^Xm       , Md^Xm       , Md^Xm       , Md^Xm       , Md          , Ce          , Dd^Vdt      , Dd          , Gs^Ft       , Gs^Ft       , Dd^Vdt      , Ce          , Dd^Do       , Gs^Ft       , Dd^Vda      , Gs^Ft       , Dd^Do       , Ce          , Dd^Vdt      , Gs^Ft       , Gs^Ft       , Dd          , Dd^Vdt      , Ce          , Md          , Md^Xm       , Md^Xm       , Md^Xm       , Md^Xm       , Hd          , Hd          
Hd          , Hd          , Md^Xm       , Md^Xm       , Md^Xm       , Md^Xm       , Ke          , Ce          , Hd          , Dd          , Dd          , Gs^Ft       , Dd          , Ce          , Md          , Dd          , Gs^Ft       , Dd          , Md          , Ce          , Dd          , Gs^Ft       , Dd          , Dd          , Hd          , Ce          , Ke          , Md^Xm       , Md^Xm       , Md^Xm       , Md^Xm       , Hd          , Hd          
Hd          , Hd          , Md^Xm       , Md^Xm       , Md^Xm       , Dd          , Dd          , Hd          , Ce          , Ce          , Ke          , Dd          , Ke          , Ce          , Ce          , Dd^Do       , Md          , Dd^Do       , Ce          , Ce          , Ke          , Dd          , Ke          , Ce          , Ce          , Hd          , Dd          , Dd          , Md^Xm       , Md^Xm       , Md^Xm       , Hd          , Hd          
Hd          , Hd          , Md^Xm       , Md^Xm       , Md^Xm       , Dd          , Dd^Vda      , Ce          , Ce          , Ce          , Hd          , Hd          , Dd          , Dd          , Dd^Vdt      , Ce          , Ce          , Ce          , Dd^Vdt      , Dd          , Dd          , Hd          , Hd          , Ce          , Ce          , Ce          , Dd^Vda      , Dd          , Md^Xm       , Md^Xm       , Md^Xm       , Hd          , Hd          
Hd          , Hd          , Md^Xm       , Md^Xm       , Md^Xm       , Dd          , Dd          , Ce          , Ce          , Ce          , Ce          , Ke          , Dd          , Gs^Ft       , Gs^Ft       , Dd          , Ke          , Dd          , Gs^Ft       , Gs^Ft       , Dd          , Ke          , Ce          , Ce          , Ce          , Ce          , Dd          , Dd          , Md^Xm       , Md^Xm       , Md^Xm       , Hd          , Hd          
Hd          , Hd          , Md^Xm       , Md^Xm       , Md^Xm       , Gs^Ft       , Dd          , 5 Ke        , Ce          , Ce          , Ce          , Ce          , Dd          , Gs^Ft       , Dd          , Dd          , Hd          , Dd          , Dd          , Gs^Ft       , Dd          , Ce          , Ce          , Ce          , Ce          , 3 Ke        , Dd          , Gs^Ft       , Md^Xm       , Md^Xm       , Md^Xm       , Hd          , Hd          
Hd          , Hd          , Md^Xm       , Md^Xm       , Md^Xm       , Dd^Vda      , Gs^Ft       , Dd          , Dd^Vda      , Ce          , Hd          , Hd          , Dd^Vdt      , Dd          , Ce          , Ke          , Hd          , Ke          , Ce          , Dd          , Dd^Vdt      , Hd          , Hd          , Ce          , Dd^Vda      , Dd          , Gs^Ft       , Dd^Vda      , Md^Xm       , Md^Xm       , Md^Xm       , Hd          , Hd          
Hd          , Hd          , Md^Xm       , Md^Xm       , Md^Xm       , Md^Xm       , Md^Xm       , Dd          , Dd          , Dd          , Ke          , Ce          , Ce          , Hd          , Ce          , Ce          , Ce          , Ce          , Ce          , Hd          , Ce          , Ce          , Ke          , Dd          , Dd          , Dd          , Md^Xm       , Md^Xm       , Md^Xm       , Md^Xm       , Md^Xm       , Hd          , Hd          
Hd          , Hd          , Hd          , Md^Xm       , Md^Xm       , Md^Xm       , Md^Xm       , Md^Xm       , Md^Xm       , Dd          , Md^Xm       , Md          , Ke          , Dd          , Ce          , Ce          , Ce          , Ce          , Ce          , Hd          , Ke          , Md          , Md^Xm       , Dd          , Md^Xm       , Md^Xm       , Md^Xm       , Md^Xm       , Md^Xm       , Md^Xm       , Hd          , Hd          , Hd          
Hd          , Hd          , Hd          , Hd          , Hd          , Md^Xm       , Md^Xm       , Md^Xm       , Md^Xm       , Md^Xm       , Md^Xm       , Md^Xm       , Dd          , Dd          , Dd^Vda      , Ce          , 4 Ke        , Ce          , Dd^Vda      , Dd          , Dd          , Md^Xm       , Md^Xm       , Md^Xm       , Md^Xm       , Md^Xm       , Md^Xm       , Md^Xm       , Hd          , Hd          , Hd          , Hd          , Hd          
Hd          , Hd          , Hd          , Hd          , Hd          , Hd          , Hd          , Md^Xm       , Md^Xm       , Md^Xm       , Md^Xm       , Md^Xm       , Md^Xm       , Dd          , Dd          , Dd          , Dd          , Dd          , Dd          , Dd          , Md^Xm       , Md^Xm       , Md^Xm       , Md^Xm       , Md^Xm       , Md^Xm       , Hd          , Hd          , Hd          , Hd          , Hd          , Hd          , Hd          
Hd          , Hd          , Hd          , Hd          , Hd          , Hd          , Hd          , Hd          , Hd          , Md^Xm       , Md^Xm       , Md^Xm       , Md^Xm       , Md^Xm       , Md^Xm       , Gs^Ft       , Dd^Vda      , Gs^Ft       , Md^Xm       , Md^Xm       , Md^Xm       , Md^Xm       , Md^Xm       , Md^Xm       , Hd          , Hd          , Hd          , Hd          , Hd          , Hd          , Hd          , Hd          , Hd          
Hd          , Hd          , Hd          , Hd          , Hd          , Hd          , Hd          , Hd          , Hd          , Hd          , Hd          , Md^Xm       , Md^Xm       , Md^Xm       , Md^Xm       , Md^Xm       , Md^Xm       , Md^Xm       , Md^Xm       , Md^Xm       , Md^Xm       , Md^Xm       , Hd          , Hd          , Hd          , Hd          , Hd          , Hd          , Hd          , Hd          , Hd          , Hd          , Hd          
Hd          , Hd          , Hd          , Hd          , Hd          , Hd          , Hd          , Hd          , Hd          , Hd          , Hd          , Hd          , Hd          , Md^Xm       , Md^Xm       , Md^Xm       , Md^Xm       , Md^Xm       , Md^Xm       , Md^Xm       , Hd          , Hd          , Hd          , Hd          , Hd          , Hd          , Hd          , Hd          , Hd          , Hd          , Hd          , Hd          , Hd          
Hd          , Hd          , Hd          , Hd          , Hd          , Hd          , Hd          , Hd          , Hd          , Hd          , Hd          , Hd          , Hd          , Hd          , Hd          , Md^Xm       , Md^Xm       , Md^Xm       , Hd          , Hd          , Hd          , Hd          , Hd          , Hd          , Hd          , Hd          , Hd          , Hd          , Hd          , Hd          , Hd          , Hd          , Hd          
Hd          , Hd          , Hd          , Hd          , Hd          , Hd          , Hd          , Hd          , Hd          , Hd          , Hd          , Hd          , Hd          , Hd          , Hd          , Hd          , Hd          , Hd          , Hd          , Hd          , Hd          , Hd          , Hd          , Hd          , Hd          , Hd          , Hd          , Hd          , Hd          , Hd          , Hd          , Hd          , Hd          
Hd          , Hd          , Hd          , Hd          , Hd          , Hd          , Hd          , Hd          , Hd          , Hd          , Hd          , Hd          , Hd          , Hd          , Hd          , Hd          , Hd          , Hd          , Hd          , Hd          , Hd          , Hd          , Hd          , Hd          , Hd          , Hd          , Hd          , Hd          , Hd          , Hd          , Hd          , Hd          , Hd          
