border_size=1
usage=map

Hd, Hd, Hd, Hd, Hd, Hd, Hd, Hd, Hd, Hd, Hd, Hd, Hd, Hd, Hd, Hd, Hd, Hd, Hd, Hd, Hd, Hd, Hd, Hd, Hd, Hd, Hd, Hd, Hd, Hd, Hd, Hd, Hd
Hd, Hd, Hd, Hd, Hd, Hd, Hd, Hd, Hd, Hd, Hd, Hd, Hd, Hd, Hd, Hd, Hd, Hd, Hd, Hd, Hd, Hd, Hd, Hd, Hd, Hd, Hd, Hd, Hd, Hd, Hd, Hd, Hd
Hd, Hd, Hd, Hd, Hd, Hd, Hd, Hd, Hd, Hd, Hd, Hd, Hd, Hd, Hd, Hd, Md^Xm, Hd, Hd, Hd, Hd, Hd, Hd, Hd, Hd, Hd, Hd, Hd, Hd, Hd, Hd, Hd, Hd
Hd, Hd, Hd, Hd, Hd, Hd, Hd, Hd, Hd, Hd, Hd, Hd, Hd, Hd, Md^Xm, Md^Xm, Md^Xm, Md^Xm, Md^Xm, Hd, Hd, Hd, Hd, Hd, Hd, Hd, Hd, Hd, Hd, Hd, Hd, Hd, Hd
Hd, Hd, Hd, Hd, Hd, Hd, Hd, Hd, Hd, Hd, Hd, Hd, Md^Xm, Md^Xm, Md^Xm, Md^Xm, Md^Xm, Md^Xm, Md^Xm, Md^Xm, Md^Xm, Hd, Hd, Hd, Hd, Hd, Hd, Hd, Hd, Hd, Hd, Hd, Hd
Hd, Hd, Hd, Hd, Hd, Hd, Hd, Hd, Hd, Hd, Md^Xm, Md^Xm, Md^Xm, Md^Xm, Md^Xm, Md^Xm, Dd^Vda, Md^Xm, Md^Xm, Md^Xm, Md^Xm, Md^Xm, Md^Xm, Hd, Hd, Hd, Hd, Hd, Hd, Hd, Hd, Hd, Hd
Hd, Hd, Hd, Hd, Hd, Hd, Hd, Hd, Md^Xm, Md^Xm, Md^Xm, Md^Xm, Md^Xm, Md^Xm, Dd, Gd^Ft, Dd, Gd^Ft, Dd, Md^Xm, Md^Xm, Md^Xm, Md^Xm, Md^Xm, Md^Xm, Hd, Hd, Hd, Hd, Hd, Hd, Hd, Hd
Hd, Hd, Hd, Hd, Hd, Hd, Md^Xm, Md^Xm, Md^Xm, Md^Xm, Md^Xm, Md^Xm, Dd, Dd, Dd^Vda, Dd, 1 Kd, Dd, Dd^Vda, Dd, Dd, Md^Xm, Md^Xm, Md^Xm, Md^Xm, Md^Xm, Md^Xm, Hd, Hd, Hd, Hd, Hd, Hd
Hd, Hd, Hd, Hd, Md^Xm, Md^Xm, Md^Xm, Md^Xm, Md^Xm, Md^Xm, Md^Xm, Md^Xm, Ke, Dd, Cd, Cd, Cd, Cd, Cd, Dd, Ke, Md^Xm, Md^Xm, Md^Xm, Md^Xm, Md^Xm, Md^Xm, Md^Xm, Md^Xm, Hd, Hd, Hd, Hd
Hd, Hd, Md^Xm, Md^Xm, Md^Xm, Md^Xm, Md^Xm, Md^Xm, Dd, Dd, Ke, Md, Ce, Hd, Cd, Cd, Cd, Cd, Cd, Hd, Ce, Md, Ke, Dd, Dd, Md^Xm, Md^Xm, Md^Xm, Md^Xm, Md^Xm, Md^Xm, Hd, Hd
Hd, Hd, Md^Xm, Md^Xm, Md^Xm, Md^Xm, Gd^Ft, Dd, Dd^Vda, Dd, Hd, Ce, Dd^Vdt, Hd, Cd, Cd, Hd, Cd, Cd, Hd, Dd^Vdt, Ce, Hd, Dd, Dd^Vda, Dd, Gd^Ft, Md^Xm, Md^Xm, Md^Xm, Md^Xm, Hd, Hd
Hd, Hd, Md^Xm, Md^Xm, Md^Xm, Dd^Vda, Dd, Dd, Cd, Cd, Cd, Hd, Dd, Dd, Dd, Kd, Hd, Kd, Dd, Dd, Dd, Hd, Cd, Cd, Cd, Dd, Dd, Dd^Vda, Md^Xm, Md^Xm, Md^Xm, Hd, Hd
Hd, Hd, Md^Xm, Md^Xm, Md^Xm, Gd^Ft, Dd, 6 Kd, Cd, Cd, Cd, Cd, Dd, Gd^Ft, Gd^Ft, Dd, Kd, Dd, Gd^Ft, Gd^Ft, Dd, Cd, Cd, Cd, Cd, 2 Kd, Dd, Gd^Ft, Md^Xm, Md^Xm, Md^Xm, Hd, Hd
Hd, Hd, Md^Xm, Md^Xm, Md^Xm, Dd, Dd^Vda, Cd, Cd, Cd, Hd, Kd, Dd, Gd^Ft, Dd^Vdt, Dd, Cd, Dd, Dd^Vdt, Gd^Ft, Dd, Kd, Hd, Cd, Cd, Cd, Dd^Vda, Dd, Md^Xm, Md^Xm, Md^Xm, Hd, Hd
Hd, Hd, Md^Xm, Md^Xm, Md^Xm, Dd, Dd, Cd, Cd, Cd, Kd, Hd, Kd, Dd, Cd, Cd, Md, Cd, Cd, Dd, Kd, Hd, Kd, Cd, Cd, Cd, Dd, Dd, Md^Xm, Md^Xm, Md^Xm, Hd, Hd
Hd, Hd, Md^Xm, Md^Xm, Md^Xm, Dd, Ke, Hd, Hd, Cd, Dd, Dd, Dd, Cd, Md, Dd^Do, Dd, Dd^Do, Md, Cd, Dd, Dd, Dd, Cd, Hd, Hd, Ke, Dd, Md^Xm, Md^Xm, Md^Xm, Hd, Hd
Hd, Hd, Md^Xm, Md^Xm, Md^Xm, Md^Xm, Md, Ce, Dd^Vdt, Dd, Gd^Ft, Gd^Ft, Dd^Vdt, Cd, Dd^Do, Gd^Ft, Dd^Vda, Gd^Ft, Dd^Do, Cd, Dd^Vdt, Gd^Ft, Gd^Ft, Dd, Dd^Vdt, Ce, Md, Md^Xm, Md^Xm, Md^Xm, Md^Xm, Hd, Hd
Hd, Hd, Md^Xm, Md^Xm, Md^Xm, Md^Xm, Ke, Ce, Hd, Dd, Dd, Gd^Ft, Dd, Cd, Md, Dd, Gd^Ft, Dd, Md, Cd, Dd, Gd^Ft, Dd, Dd, Hd, Ce, Ke, Md^Xm, Md^Xm, Md^Xm, Md^Xm, Hd, Hd
Hd, Hd, Md^Xm, Md^Xm, Md^Xm, Dd, Dd, Hd, Cd, Cd, Kd, Dd, Kd, Cd, Cd, Dd^Do, Md, Dd^Do, Cd, Cd, Kd, Dd, Kd, Cd, Cd, Hd, Dd, Dd, Md^Xm, Md^Xm, Md^Xm, Hd, Hd
Hd, Hd, Md^Xm, Md^Xm, Md^Xm, Dd, Dd^Vda, Cd, Cd, Cd, Hd, Hd, Dd, Dd, Dd^Vdt, Cd, Cd, Cd, Dd^Vdt, Dd, Dd, Hd, Hd, Cd, Cd, Cd, Dd^Vda, Dd, Md^Xm, Md^Xm, Md^Xm, Hd, Hd
Hd, Hd, Md^Xm, Md^Xm, Md^Xm, Dd, Dd, Cd, Cd, Cd, Cd, Kd, Dd, Gd^Ft, Gd^Ft, Dd, Kd, Dd, Gd^Ft, Gd^Ft, Dd, Kd, Cd, Cd, Cd, Cd, Dd, Dd, Md^Xm, Md^Xm, Md^Xm, Hd, Hd
Hd, Hd, Md^Xm, Md^Xm, Md^Xm, Gd^Ft, Dd, 5 Kd, Cd, Cd, Cd, Cd, Dd, Gd^Ft, Dd, Dd, Hd, Dd, Dd, Gd^Ft, Dd, Cd, Cd, Cd, Cd, 3 Kd, Dd, Gd^Ft, Md^Xm, Md^Xm, Md^Xm, Hd, Hd
Hd, Hd, Md^Xm, Md^Xm, Md^Xm, Dd^Vda, Gd^Ft, Dd, Dd^Vda, Cd, Hd, Hd, Dd^Vdt, Dd, Cd, Kd, Hd, Kd, Cd, Dd, Dd^Vdt, Hd, Hd, Cd, Dd^Vda, Dd, Gd^Ft, Dd^Vda, Md^Xm, Md^Xm, Md^Xm, Hd, Hd
Hd, Hd, Md^Xm, Md^Xm, Md^Xm, Md^Xm, Md^Xm, Dd, Dd, Dd, Ke, Ce, Ce, Hd, Cd, Cd, Cd, Cd, Cd, Hd, Ce, Ce, Ke, Dd, Dd, Dd, Md^Xm, Md^Xm, Md^Xm, Md^Xm, Md^Xm, Hd, Hd
Hd, Hd, Hd, Md^Xm, Md^Xm, Md^Xm, Md^Xm, Md^Xm, Md^Xm, Dd, Md^Xm, Md, Ke, Dd, Cd, Cd, Cd, Cd, Cd, Hd, Ke, Md, Md^Xm, Dd, Md^Xm, Md^Xm, Md^Xm, Md^Xm, Md^Xm, Md^Xm, Hd, Hd, Hd
Hd, Hd, Hd, Hd, Hd, Md^Xm, Md^Xm, Md^Xm, Md^Xm, Md^Xm, Md^Xm, Md^Xm, Dd, Dd, Dd^Vda, Cd, 4 Kd, Cd, Dd^Vda, Dd, Dd, Md^Xm, Md^Xm, Md^Xm, Md^Xm, Md^Xm, Md^Xm, Md^Xm, Hd, Hd, Hd, Hd, Hd
Hd, Hd, Hd, Hd, Hd, Hd, Hd, Md^Xm, Md^Xm, Md^Xm, Md^Xm, Md^Xm, Md^Xm, Dd, Dd, Dd, Dd, Dd, Dd, Dd, Md^Xm, Md^Xm, Md^Xm, Md^Xm, Md^Xm, Md^Xm, Hd, Hd, Hd, Hd, Hd, Hd, Hd
Hd, Hd, Hd, Hd, Hd, Hd, Hd, Hd, Hd, Md^Xm, Md^Xm, Md^Xm, Md^Xm, Md^Xm, Md^Xm, Gd^Ft, Dd^Vda, Gd^Ft, Md^Xm, Md^Xm, Md^Xm, Md^Xm, Md^Xm, Md^Xm, Hd, Hd, Hd, Hd, Hd, Hd, Hd, Hd, Hd
Hd, Hd, Hd, Hd, Hd, Hd, Hd, Hd, Hd, Hd, Hd, Md^Xm, Md^Xm, Md^Xm, Md^Xm, Md^Xm, Md^Xm, Md^Xm, Md^Xm, Md^Xm, Md^Xm, Md^Xm, Hd, Hd, Hd, Hd, Hd, Hd, Hd, Hd, Hd, Hd, Hd
Hd, Hd, Hd, Hd, Hd, Hd, Hd, Hd, Hd, Hd, Hd, Hd, Hd, Md^Xm, Md^Xm, Md^Xm, Md^Xm, Md^Xm, Md^Xm, Md^Xm, Hd, Hd, Hd, Hd, Hd, Hd, Hd, Hd, Hd, Hd, Hd, Hd, Hd
Hd, Hd, Hd, Hd, Hd, Hd, Hd, Hd, Hd, Hd, Hd, Hd, Hd, Hd, Hd, Md^Xm, Md^Xm, Md^Xm, Hd, Hd, Hd, Hd, Hd, Hd, Hd, Hd, Hd, Hd, Hd, Hd, Hd, Hd, Hd
Hd, Hd, Hd, Hd, Hd, Hd, Hd, Hd, Hd, Hd, Hd, Hd, Hd, Hd, Hd, Hd, Hd, Hd, Hd, Hd, Hd, Hd, Hd, Hd, Hd, Hd, Hd, Hd, Hd, Hd, Hd, Hd, Hd
Hd, Hd, Hd, Hd, Hd, Hd, Hd, Hd, Hd, Hd, Hd, Hd, Hd, Hd, Hd, Hd, Hd, Hd, Hd, Hd, Hd, Hd, Hd, Hd, Hd, Hd, Hd, Hd, Hd, Hd, Hd, Hd, Hd
