border_size=1
usage=map

Wwt, Gs, Wwt, Wwt, Wwt, Gs, Gs, Gs, Gd, Gs, Gd, Gd, Gs, Gd, Gs, Gs, Gs, Gs, Gs, Gs, Gs, Gd, Gd, Gs, Wwt, Wwt, Gs, Gs, Gs, Gs, Gs, Gs, Gs
Gd^Ft, Wwt, Gs, Gs, Gd^Ft, Wwt, Wwt, Gs, Gd^Ft, Gd, Gd, Gs, Gd, Gd, Gs, Gs, Gs, Gs, Gd, Gs, Gd^Fts, Gd, Gd^Ft, Gd^Ft, Wwt, Gs, Gs, Gs, Gs, Gs, Gd, Gs, Gs
Gd, Gs^Ft, Gs, Gd^Fts, Gs, Gs, Wwt, Gs, Gd^Ft, Gd, Gd, Gd, Gs, Gs, Gs, Gs, Mm^Xm, Gd, Gs, Gs, Gd^Fts, Gd^Ft, Wwt, Wwt, Gs, Gs, Gs, Gs, Gd, Gd, Gs, Gs, Gs
Gs, Gd, Gd, Gd, Gs, Gs, Gs, Wwt, Wwt, Gs, Gs, Gs, Gs, Gs, Mm^Xm, Mm^Xm, Mm^Xm, Mm^Xm, Mm^Xm, Gs, Gs, Gs, Wwt, Gs^Ft, Gs, Gd^Fts, Gd, Gd, Gd^Fts, Gd^Fts, Gs, Gs, Gs
Gs, Gd, Gd^Fts, Gs, Gs, Gd^Ft, Gd^Ft, Gs, Wwt, Gs, Gs, Gs, Mm^Xm, Mm^Xm, Mm^Xm, Mm^Xm, Mm^Xm, Mm^Xm, Mm^Xm, Mm^Xm, Mm^Xm, Gs, Gs, Wwt, Gs, Gd^Fts, Gs, Gd, Gd, Gd, Gd^Fts, Gs, Gs
Gs, Gd, Gs, Gd, Gd, Gd, Gs, Gs, Wwt, Gs, Mm^Xm, Mm^Xm, Mm^Xm, Mm^Xm, Mm^Xm, Mm^Xm, Gs^Vht, Mm^Xm, Mm^Xm, Mm^Xm, Mm^Xm, Mm^Xm, Mm^Xm, Wwt, Gs, Gd^Fts, Gs, Gd, Gd, Gs, Gs, Gd^Fts, Gs
Gd, Gd, Gd^Fts, Gd^Fts, Gd, Gs, Gs, Gs, Mm^Xm, Mm^Xm, Mm^Xm, Mm^Xm, Mm^Xm, Mm^Xm, Gd, Gd^Fts, Gs, Gd^Fts, Gs, Mm^Xm, Mm^Xm, Mm^Xm, Mm^Xm, Mm^Xm, Mm^Xm, Gs, Gs, Gd, Gs, Gs, Gs, Gd^Fts, Gs
Gd^Fts, Gd, Gd, Gd, Gs, Gd, Mm^Xm, Mm^Xm, Mm^Xm, Mm^Xm, Mm^Xm, Mm^Xm, Gs, Gd, Gs^Vht, Gs, 1 Ke, Gd, Gs^Vht, Gs, Gs, Mm^Xm, Mm^Xm, Mm^Xm, Mm^Xm, Mm^Xm, Mm^Xm, Gs, Gs, Gs, Wwt, Wwt, Wwt
Gs, Gs, Gs, Gs, Mm^Xm, Mm^Xm, Mm^Xm, Mm^Xm, Mm^Xm, Mm^Xm, Mm^Xm, Mm^Xm, Ke, Gs, Ce, Ce, Ce, Ce, Ce, Gs, Ke, Mm^Xm, Mm^Xm, Mm^Xm, Mm^Xm, Mm^Xm, Mm^Xm, Mm^Xm, Mm^Xm, Wwt, Gs, Gs, Gs
Gs, Gs, Mm^Xm, Mm^Xm, Mm^Xm, Mm^Xm, Mm^Xm, Mm^Xm, Gs, Gs, Ke, Hhd, Ce, Gs, Ce, Ce, Ce, Ce, Ce, Gs, Ce, Hhd, Ke, Gs, Gs, Mm^Xm, Mm^Xm, Mm^Xm, Mm^Xm, Mm^Xm, Mm^Xm, Gd, Gs
Gs, Gs, Mm^Xm, Mm^Xm, Mm^Xm, Mm^Xm, Gs^Ft, Gs, Gs^Vht, Gs, Gs, Ce, Gs^Vc, Gs, Ce, Ce, Gs, Ce, Ce, Gd, Gs^Vc, Ce, Gs, Gs, Gs^Vht, Gd, Gs^Ft, Mm^Xm, Mm^Xm, Mm^Xm, Mm^Xm, Gd, Gd
Gs, Gs, Mm^Xm, Mm^Xm, Mm^Xm, Gs^Vht, Gd, Gd, Ce, Ce, Ce, Gs, Gs, Gd, Gs, Ket, Gs, Ket, Gs, Gd, Gd, Gs, Ce, Ce, Ce, Gd, Gd, Gs^Vht, Mm^Xm, Mm^Xm, Mm^Xm, Gs, Gs
Gd, Gd, Mm^Xm, Mm^Xm, Mm^Xm, Gd^Fts, Gd, 6 Ke, Ce, Ce, Ce, Ce, Gd, Gd^Fts, Gs^Ft, Gs, Ket, Gs, Gd^Ft, Gd^Ft, Gs, Ce, Ce, Ce, Ce, 2 Ke, Gs, Gs^Ft, Mm^Xm, Mm^Xm, Mm^Xm, Gs, Gs
Gs, Gd, Mm^Xm, Mm^Xm, Mm^Xm, Gd, Gs^Vht, Ce, Ce, Ce, Gs, Ket, Gs, Gs^Ft, Gs^Vc, Gs, Ce, Gs, Gs^Vc, Gd^Fts, Gs, Ket, Gs, Ce, Ce, Ce, Gs^Vht, Gs, Mm^Xm, Mm^Xm, Mm^Xm, Gs, Gs
Gd^Fts, Gs, Mm^Xm, Mm^Xm, Mm^Xm, Gd, Gs, Ce, Ce, Ce, Ket, Gs, Ket, Gs, Ce, Ce, Gs^Ft, Ce, Ce, Gs, Ket, Gs, Ket, Ce, Ce, Ce, Gs, Gs, Mm^Xm, Mm^Xm, Mm^Xm, Gd, Gs
Gs, Gs, Mm^Xm, Mm^Xm, Mm^Xm, Gs, Ke, Gs, Gs, Ce, Gs, Gs, Gs, Ce, Gs^Ft, Gs, Gd, Gs, Gs^Ft, Ce, Gs, Gs, Gs, Ce, Gs, Gs, Ke, Gs, Mm^Xm, Mm^Xm, Mm^Xm, Gd, Gs
Gs, Gs, Mm^Xm, Mm^Xm, Mm^Xm, Mm^Xm, Hhd, Ce, Gs^Vc, Gs, Gd^Ft, Gd^Fts, Gs^Vc, Ce, Gs, Gs^Ft, Gd^Vht, Gd^Fts, Gd, Ce, Gs^Vc, Gs^Ft, Gd^Ft, Gs, Gs^Vc, Ce, Hhd, Mm^Xm, Mm^Xm, Mm^Xm, Mm^Xm, Gs, Gd^Fts
Gd, Gd, Mm^Xm, Mm^Xm, Mm^Xm, Mm^Xm, Ke, Ce, Gs, Gs, Gs, Gd^Fts, Gs, Ce, Gs^Ft, Gd, Gd^Fts, Gs, Gs^Ft, Ce, Gs, Gs^Ft, Gs, Gd, Gs, Ce, Ke, Mm^Xm, Mm^Xm, Mm^Xm, Mm^Xm, Gs, Gs
Gs, Gs, Mm^Xm, Mm^Xm, Mm^Xm, Gs, Gs, Gs, Ce, Ce, Ket, Gs, Ket, Ce, Ce, Gs, Gd^Ft, Gd, Ce, Ce, Ket, Gs, Ket, Ce, Ce, Gs, Gs, Gs, Mm^Xm, Mm^Xm, Mm^Xm, Gs, Gs
Gd^Fts, Gs, Mm^Xm, Mm^Xm, Mm^Xm, Gs, Gs^Vht, Ce, Ce, Ce, Gs, Gs, Gs, Gs, Gs^Vc, Ce, Ce, Ce, Gs^Vc, Gs, Gs, Gs, Gs, Ce, Ce, Ce, Gs^Vht, Gs, Mm^Xm, Mm^Xm, Mm^Xm, Gd^Fts, Gd
Gs, Gs, Mm^Xm, Mm^Xm, Mm^Xm, Gs, Gs, Ce, Ce, Ce, Ce, Ket, Gs, Gd^Ft, Gs^Ft, Gs, Ket, Gs, Gd^Fts, Gd^Ft, Gs, Ket, Ce, Ce, Ce, Ce, Gd, Gs, Mm^Xm, Mm^Xm, Mm^Xm, Gs, Gd^Fts
Gs, Gs, Mm^Xm, Mm^Xm, Mm^Xm, Gs^Ft, Gd, 5 Ke, Ce, Ce, Ce, Ce, Gd, Gd^Fts, Gs, Gs, Gs, Gs, Gd, Gd^Ft, Gs, Ce, Ce, Ce, Ce, 3 Ke, Gd, Gd^Fts, Mm^Xm, Mm^Xm, Mm^Xm, Gs, Gs
Gs, Gs, Mm^Xm, Mm^Xm, Mm^Xm, Gs^Vht, Gd^Fts, Gs, Gs^Vht, Ce, Gs, Gs, Gs^Vc, Gs, Ce, Ket, Gs, Ket, Ce, Gs, Gs^Vc, Gs, Gs, Ce, Gs^Vht, Gs, Gd^Fts, Gs^Vht, Mm^Xm, Mm^Xm, Mm^Xm, Gs, Gs
Gs, Gs, Mm^Xm, Mm^Xm, Mm^Xm, Mm^Xm, Mm^Xm, Gd, Gd, Gs, Ke, Ce, Ce, Gd, Ce, Ce, Ce, Ce, Ce, Gs, Ce, Ce, Ke, Gs, Gs, Gd, Mm^Xm, Mm^Xm, Mm^Xm, Mm^Xm, Mm^Xm, Gs, Gs
Gd^Fts, Gs, Gs, Mm^Xm, Mm^Xm, Mm^Xm, Mm^Xm, Mm^Xm, Mm^Xm, Gs, Mm^Xm, Hhd, Ke, Gs, Ce, Ce, Ce, Ce, Ce, Gs, Ke, Hhd, Mm^Xm, Gs, Mm^Xm, Mm^Xm, Mm^Xm, Mm^Xm, Mm^Xm, Mm^Xm, Wwt, Gs, Gs
Wwt, Gd^Fts, Wwt, Wwt, Gs, Mm^Xm, Mm^Xm, Mm^Xm, Mm^Xm, Mm^Xm, Mm^Xm, Mm^Xm, Gs, Gs, Gs^Vht, Ce, 4 Ke, Ce, Gd^Vht, Gd, Gs, Mm^Xm, Mm^Xm, Mm^Xm, Mm^Xm, Mm^Xm, Mm^Xm, Mm^Xm, Gs, Gs, Gd^Fts, Wwt, Gs
Gs, Wwt, Gd^Fts, Gs, Gd, Gs, Gs, Mm^Xm, Mm^Xm, Mm^Xm, Mm^Xm, Mm^Xm, Mm^Xm, Gd, Gs, Gs, Gs, Gd, Gd, Gs, Mm^Xm, Mm^Xm, Mm^Xm, Mm^Xm, Mm^Xm, Mm^Xm, Gs, Gd, Gs, Gs, Gs, Wwt, Gs
Gs, Gs, Gs, Gs, Gd, Gd, Gs, Gs, Gs, Mm^Xm, Mm^Xm, Mm^Xm, Mm^Xm, Mm^Xm, Mm^Xm, Gd^Fts, Gs^Vht, Gd^Ft, Mm^Xm, Mm^Xm, Mm^Xm, Mm^Xm, Mm^Xm, Mm^Xm, Wwt, Gs, Gs, Gd, Gd, Gs, Gs, Wwt, Wwt
Gs, Gs, Gd, Gd, Gd^Ft, Gd^Fts, Gs, Gs, Gs, Gs, Gs, Mm^Xm, Mm^Xm, Mm^Xm, Mm^Xm, Mm^Xm, Mm^Xm, Mm^Xm, Mm^Xm, Mm^Xm, Mm^Xm, Mm^Xm, Gs, Gd^Ft, Wwt, Gs, Gd, Gd^Fts, Gd, Gd, Gs, Gs, Gs
Gd, Gd, Gs, Gd, Gd^Fts, Gd^Fts, Gd, Gs, Gd, Gs, Gs, Gs, Wwt, Mm^Xm, Mm^Xm, Mm^Xm, Mm^Xm, Mm^Xm, Mm^Xm, Mm^Xm, Gs, Gs, Gs, Wwt, Gs^Ft, Gs^Ft, Gd, Gs, Gs, Gd^Fts, Gd, Gs, Gs
Gd, Gs, Gd, Gd^Fts, Gs, Gd, Gd^Fts, Gd, Gs, Gs, Gd^Ft, Wwt, Gs, Gs, Gs, Mm^Xm, Mm^Xm, Mm^Xm, Gs, Gs, Gs, Gs, Gs, Wwt, Gd^Ft, Gs^Ft, Wwt, Gs, Gs, Gd^Fts, Gd, Gd, Gs
Gs, Gd, Gs, Gd, Gs, Gs, Gs, Gs, Gs, Gd^Fts, Gs, Wwt, Gs, Gd, Gd, Gs, Gd, Gs, Gd^Fts, Gs, Gd, Gd, Gs, Wwt, Wwt, Wwt, Gs^Ft, Wwt, Gs, Gs, Gd^Fts, Gd, Gs
Gs, Gs, Gs, Gs, Gs, Gd, Gd, Gs, Gs, Gs, Wwt, Wwt, Gs, Gd^Ft, Gs, Gd, Gs, Gd, Gs, Gs, Gs, Gd, Gs, Gs, Gs, Gs, Wwt, Wwt, Gs, Gs, Gs, Gs, Gs
