border_size=1
usage=map

Mm^Xm       , Mm^Xm       , Mm^Xm       , Gs^Fds      , Gs^Fds      , Gs^Fds      , Gs^Fds      , Gs^Fds      , Gs^Fds      , Gs^Fds      , Gs^Fds      , Gs^Fds      , Gs^Fds      , Gs^Fds      , Gs^Fds      , Gs^Fds      , Gs^Fds      , Gs^Fds      , Gs^Fds      , Gs^Fds      , Gs^Fds      , Gs^Fds      , Gs^Fds      , Gs^Fds      , Gs^Fds      , Gs^Fds      , Gs^Fds      , Rd          , Rd          , Gs^Fds      , Gs^Fds      , Gs^Fdw      , Gs^Fdw      , Gs^Fdw      , Gs^Fdw      , Ss          , Ss          , Gs^Fdw      , Gs^Fdw      , Gs^Fdw      , Ss          , Ss          , Ss          , Ss          , Ss          , Ss
Mm^Xm       , 6 Md        , Mm^Xm       , Gs^Fds      , Gs^Fds      , Gs^Fds      , Gg^Efm      , Gs^Fds      , Gs^Fds      , Gs^Fds      , Gs^Fds      , Gs^Fds      , Gs^Fds      , Gs^Fds      , Gs^Fds      , Gs^Fds      , Gs^Fds      , Gs^Fds      , Hh^Fds      , Gs^Fds      , Gs^Fds      , Gs^Fds      , Gs^Fds      , Gs^Fds      , Gg^Efm      , Gs^Fds      , Gg^Efm      , Rd          , Rd          , Rd          , Gs^Fds      , Gs^Fds      , Gs^Fdw      , Gs^Fdw      , Gs^Fdw      , Gs^Fdw      , Ss          , Ss          , Ss          , Ss          , Khs         , Gs^Fdw      , Gs^Fdw      , Ss          , Ss          , Ss
Mm^Xm       , Mm^Xm       , Mm^Xm       , Gs^Fds      , Gs^Fds      , Gs^Fds      , Gg^Efm      , Gg^Efm      , Gg          , Gg          , Gg          , Gs^Fds      , Gs^Fds      , Gs^Fds      , Gs^Fds      , Gs^Fds      , Gs^Fds      , Gs^Fds      , Gs^Fds      , Gs^Fds      , Gs^Fds      , Gs^Fds      , Gs^Fds      , Gs^Fds      , Gs^Fds      , Gg^Efm      , Gg^Efm      , Gg^Ve       , Gs^Fds      , Rd          , Rd          , Gs^Fds      , Hh^Fds      , Gs^Fdw      , Gs^Fdw      , Gs^Fdw      , Gs^Fdw      , Ss          , Ss          , Chs         , Chs         , Ss          , Gs          , Ss^Vhs      , Ss          , Ss
Mm^Xm       , Mm^Xm       , Gs^Fds      , Gs^Fds      , Gs^Fds      , Gg^Efm      , Gg^Ve       , Gs^Fds      , Gg          , Gs^Fds      , Gs^Fds      , Gs^Fds      , Hh^Fds      , Gs^Fds      , Gs^Fds      , Gs^Fds      , Gg^Efm      , Gg^Efm      , Gg^Ve       , Gg^Efm      , Gg^Efm      , Gg^Efm      , Gg^Efm      , Gs^Fds      , Gs^Fds      , Gg^Efm      , Gs^Fds      , Gg^Efm      , Gs^Fds      , Gs^Fds      , Rd          , Gs^Fds      , Gs^Fds      , Hh^Fds      , Gs^Fds      , Gs^Fds      , Gs^Fdw      , Gs^Fdw      , Gs^Fdw      , Ss          , Ss          , Ss          , Gs          , Gs          , Ss          , Ss
Gs^Fds      , Gs^Fds      , Gs^Fds      , Hh^Fds      , Gs^Fds      , Gs^Fds      , Gs^Fds      , Gs^Fds      , Gs^Fds      , Gs^Fds      , Gs^Fds      , Gs^Fds      , Gs^Fds      , Hh^Fds      , Gs^Fds      , Gs^Fds      , Gs^Fds      , Gs^Fds      , Cv          , Gs^Fds      , Cv          , Gs^Fds      , Gg^Ve       , Gg^Efm      , Gs^Fds      , Gs^Fds      , Cv          , Gs^Fds      , Gs^Fds      , Gs^Fds      , Rd          , Rd          , Rd          , Gs^Fds      , Gs^Fds      , Gs^Fds      , Gs^Fds      , Gs^Fdw      , Gs^Fdw      , Ss          , Ss          , Ss          , Ss          , Gs^Fdw      , Ss          , Ss
Gs^Fms      , Gs^Fds      , Gs^Fds      , Hh^Fds      , Gs^Fds      , Gs^Fds      , Gs^Fds      , Hh^Fds      , Gs^Fds      , Gg^Efm      , Gg^Efm      , Gs^Fds      , Gs^Fds      , Hh^Fds      , Gs^Fds      , Gs^Fds      , Gs^Fds      , Gg^Efm      , Cv          , Cv          , Gs^Fds      , Gs^Fds      , Gg^Efm      , Gg^Efm      , Gs^Fds      , Gs^Fds      , Cv          , Gs^Fds      , Gs^Fds      , Hh^Fds      , Hh^Fds      , Hh^Fds      , Rd          , Rd          , Gs^Fds      , Gs^Fds      , Hh^Fds      , Gs^Fdw      , Gs^Fdw      , Gs^Fdw      , Ss^Vhs      , Ss          , Ss          , Ss          , Ss          , Ss
Gs^Fms      , Gs^Fms      , Gs^Fms      , Gs^Fds      , Gs^Fms      , Cv          , Gs^Fds      , Hh^Fds      , Gs^Fds      , Gs^Fds      , Gg^Ve       , Gs^Fds      , Gs^Fds      , Gs^Fds      , Gs^Fds      , Gg^Ve       , Gg^Efm      , Gg^Efm      , Gs^Fds      , Kv          , Gs^Fds      , Gg^Efm      , Gg^Efm      , Hh^Fds      , Hh^Fds      , Gs^Fds      , Gs^Fds      , Gs^Fds      , Rd          , Gs^Fds      , Rd          , Hh^Fds      , Rd          , Gs^Fds      , Gs^Fds      , Hh^Fds      , Hh^Fds      , Gs^Fdw      , Gs^Fdw      , Ss          , Wo          , Wo          , Ss          , Ss          , Ss          , Ss
Gs^Fms      , Gs^Fms      , Gs^Fms      , Gs^Fms      , Cv          , Kv          , Cv          , Gs^Fms      , Gs^Fms      , Gs^Fds      , Gg^Efm      , Gg^Efm      , Gs^Fds      , Gs^Fds      , Gs^Fds      , Gs^Fds      , Gs^Fds      , Gg^Efm      , Gg^Efm      , Gg^Efm      , Gg^Efm      , Gs^Fds      , Gg^Efm      , Gg^Efm      , Hh^Fds      , Gs^Fds      , Gs^Fds      , Gs^Fds      , Gs^Fds      , Rd          , Gs^Fds      , Rd          , Rd          , Rd          , Ww^Bw\      , Hh^Fds      , Gs^Fds      , Hh^Fds      , Ww          , Wwf         , Wo          , Ss          , Gs^Fdw      , Gs^Fdw      , Gs^Fdw      , Ss
Hh^Fms      , Gs^Fms      , Hh^Fms      , Gs^Fms      , Gs^Fms      , Gg^Ve       , Gs^Fms      , Gs^Fms      , Gs^Fms      , Gs^Fms      , Gs^Fms      , Gs^Fms      , Gs^Fms      , Gg^Ve       , Gs^Fms      , Gs^Fms      , Gs^Fms      , Gs^Fds      , Gs^Fms      , Gs^Fds      , Gs^Fds      , Gg^Ve       , Gs^Fds      , Gs^Fds      , Gs^Fds      , Gs^Fds      , Gg^Efm      , Gs^Fds      , Hh^Fds      , Hh^Fds      , Gs^Fds      , Gs^Fds      , Wo          , Ww          , Wo^Bw|      , Ww          , Wo          , Wo          , Wo          , Ww          , Wwf         , Gs^Fdw      , Hh^Fds      , Gs^Fdw      , Gs^Fdw      , Gs^Fdw
Hh^Fms      , Hh^Fms      , Hh          , Hh^Fms      , Hh^Fp       , Hh^Fms      , Hh          , Hh^Fms      , Hh^Fms      , Hh^Fms      , Hh^Fms      , Gs^Fms      , Hh^Fms      , Gs^Fms      , Gs^Fms      , Gs^Fms      , Gs^Fms      , Gs^Fms      , Gs^Fms      , Gs^Fds      , Gs^Fds      , Gs^Fds      , Gs^Fds      , Gs^Fds      , Gs^Fds      , Gg^Efm      , Gg^Ve       , Gs^Fds      , Wo          , Wo          , Wo          , Wwf         , Ww          , Wo^Bw|      , Rd          , Ww          , Wo          , Ww          , Gs^Fds      , Ww          , Gs^Fds      , Hh^Fds      , Gs^Fds      , Hh^Fds      , Gs^Fds      , Gs^Fdw
Hh^Fp       , Hh^Fp       , Hh          , Hh^Fp       , Hh^Fp       , Hh^Fp       , Hh          , Hh^Fp       , Hh          , Hh^Fms      , Hh          , Hh          , Hh^Fp       , Hh^Fms      , Hh^Fms      , Hh^Fms      , Hh^Fms      , Gs^Fms      , Hh          , Gs^Fms      , Gs^Fms      , Cv          , Kv          , Cv          , Gs^Fds      , Gs^Fds      , Wwf         , Wwf         , Wo          , Wo          , Ww          , Ww          , Ce          , Rd          , Rd          , Hh          , Ce          , Hh          , Gg          , Gs^Fds      , Gs^Fds      , Gs^Fds      , Gs^Fds      , Gs^Fds      , Gs^Fds      , Gs^Fds
Hh^Fp       , Hh          , Hh          , Hh^Fp       , Hh          , Hh^Fp       , Hh^Fp       , Hh          , Hh^Fp       , Hh^Fp       , Chr         , Hh          , Hh^Fp       , Hh^Fp       , Hh^Fp       , Hh^Fp       , Hh^Fp       , Hh^Fms      , Hh          , Gs^Fms      , Hh^Fms      , Gs^Fms      , Gs^Fms      , Gs^Fms      , Gs^Fms      , Gs^Fms      , Ww          , Wwf         , Gs^Fds      , Ce          , Hh          , Hh          , Gg          , Rd          , Rd          , Hh          , Gg          , Ce          , Gs^Fds      , Gs^Fds      , Gs^Fds      , Gg^Efm      , Gg^Ve       , Gg^Efm      , Gs^Fds      , Gs^Fds
Hh^Fms      , Hh          , Hh^Fms      , Hh^Fms      , Khr         , Hh          , Chr         , Hh^Fp       , Hh^Fms      , Hh^Fp       , Chr         , Hh^Fp       , Hh^Fp       , Hh^Fp       , Hh^Fp       , Hh^Fp       , Hh^Fp       , Hh          , Hh^Vc       , Hh^Fms      , Hh^Fp       , Hh^Fms      , Hh^Fms      , Gs^Fms      , Ww          , Ww          , Wwf         , Gs^Fms      , Gs^Fds      , Ce          , Ce          , Gg          , Gg^Vh       , Rd          , Rd          , Gg^Vh       , Gs^Fds      , Ce          , Ce          , Gs^Fds      , Gs^Fds      , Gg^Efm      , Gs^Fds      , Gg^Efm      , Gs^Fds      , Gs^Fds
Hh          , Hh          , Hh          , Chr         , Hh^Fms      , Hh          , Hh^Vhh      , Chr         , Hh          , Khr         , Hh          , Hh^Fms      , Hh^Fms      , Hh          , Hh^Fp       , Hh^Fp       , Hh^Fp       , Hh          , Hh^Fp       , Hh^Fp       , Hh          , Hh^Fp       , Hh^Fms      , Hh^Fms      , Ww          , Wo          , Gs^Fms      , Gs^Fms      , Gs^Fms      , Gs^Fds      , Hh          , Hh          , Gg          , Rd          , Rd          , Gg          , Ce          , Gs^Fds      , Gs^Fds      , Gs^Fds      , Gs^Fds      , Gs^Fds      , Gs^Fds      , Gs^Fds      , Hh^Fds      , Hh^Fds
Gs          , Hh          , Gs^Fms      , Hh          , Gs^Fms      , Hh^Fms      , Gs^Fms      , Hh^Fms      , Hh          , Hh^Fms      , Gs          , Hh          , Hh          , Hh          , Mm          , Mm          , Mm          , Hh^Fp       , Hh^Fp       , Hh^Fp       , Hh^Fp       , Hh          , Hh^Fp       , Hh^Fms      , Wo          , Ww          , Ww          , Gs^Fms      , Gs^Fms      , Gs^Fms      , Hh          , Ce          , Ce          , Rd          , Rd          , Gg^Vh       , Ce          , Gs^Fds      , Gg^Efm      , Gs^Fds      , Gg^Efm      , Gg^Efm      , Hh          , Hh^Fds      , Hh          , Hh^Fds
Gs^Fds      , Gs          , Gs          , Gs          , Gs          , Gs^Fms      , Gs          , Gs          , Gs          , Gs          , Gs          , Gs^Fms      , Gs^Fms      , Hh^Fms      , Hh^Fms      , Mm          , Hh^Fms      , Hh^Fms      , Chr         , Hh^Fms      , Hh          , Hh^Fp       , Hh^Fp       , Ww          , Wo          , Wo          , Hh^Fms      , Hh^Fms      , Hh^Fms      , Gs^Fms      , Gs^Fp       , Hh          , Rd          , Rd          , Rd          , Ce          , Gg          , Gg          , Gs^Fds      , Gg^Efm      , Gg^Ve       , Gg^Efm      , Cv          , Hh          , Gs^Fds      , Hh^Fds
Gs^Fds      , Gs          , Gs          , Gs          , Gs          , Gs          , Gs          , Gs^Fds      , Gs          , Gs^Fds      , Gs^Fds      , Gs          , Gs^Fds      , Gs^Fms      , Rp          , Rp          , Rp          , Khr         , Ch          , Hh^Fms      , Hh^Fms      , Hh          , Mm          , Wo          , Mm          , Wo          , Hh          , Hh^Fms      , Hh^Fms      , Hh^Fms      , Re          , Rd          , Rd          , Rd          , Gs^Fms      , Gs^Fms      , Hh          , Gg          , Gs^Fds      , Gg^Efm      , Gg^Efm      , Cv          , Kv          , Gs^Fds      , Gs^Fds      , Gs^Fds
Wwr         , Gs^Fds      , Ww          , Gs^Vht      , Wo          , Gs^Fds      , Gs          , Gs          , Gs^Fds      , Gs          , Chr         , Gs          , Rp          , Gs^Fms      , Rp          , Hh^Fms      , Hh^Fms      , Chr         , Hh^Fms      , Hh^Fms      , Mm          , Mm          , Mm          , Mm          , Mm          , Mm          , Hh          , Hh^Fp       , Hh^Fp       , Hh^Fms      , Re          , Re          , Hh^Fms      , Gs^Fms      , Gs^Fms      , Gs^Fms      , Hh          , Gs^Fms      , Gs^Fds      , Gs^Fds      , Gg^Efm      , Gg^Ve       , Cv          , Gg^Efm      , Gs^Fds      , Gs^Fds
Wwr         , Wwr         , Wo          , Wo          , Wo          , Ww          , Ww          , Hh^Fds      , Rp          , Rp          , Rp          , Rp          , Hh          , Rp          , Gs^Fds      , Gs^Fms      , Gs^Fms      , Hh^Fms      , Hh^Fms      , Hh          , Hh          , Mm          , Mm          , Mm          , Hh^Fms      , Mm          , Mm          , Hh          , Hh^Fp       , Hh^Fms      , Re          , Re          , Hh^Fms      , Hh^Fms      , Hh          , Gs^Fms      , Gs^Fms      , Gs^Fms      , Gs^Fms      , Gs^Fds      , Gs^Fds      , Gg^Efm      , Gs^Fds      , Gg^Efm      , Gs^Fds      , Gs^Fds
Wwr         , Wwr         , Wo          , Wo          , Wo          , Ww          , Ww          , Rp          , Ww          , Hh^Fds      , Gs^Fds      , Gs^Fds      , Hh          , Gs^Fds      , Gg          , Gs^Fds      , Gg          , Hh^Fms      , Gs^Fms      , Hh          , Ww          , Hh          , Hh          , Hh          , Hh^Fms      , Mm          , Mm          , Hh          , Hh^Fp       , Hh^Fp       , Rd          , Re          , Ce          , Hh^Fms      , Hh^Fms      , Gs^Fms      , Gs^Fms      , Gg^Efm      , Gg^Efm      , Gs^Fds      , Gg          , Gs^Fds      , Hh          , Gs^Fds      , Gs^Fds      , Gs^Fds
Wwr         , Wwf         , Ww          , Wo          , Ww          , Wo          , Wwf         , Wwf         , Ww          , Ww^Vm       , Gs^Fds      , Hh^Fds      , Gg          , Gs^Fds      , Gg          , Gs^Fds      , Gg^Vc       , Gg          , Gg          , Wwf         , Wo          , Ww          , Wwf         , Hh          , Hh^Fms      , Hh          , Hh          , Hh          , Rd          , Rd          , Rd          , Rd          , Hh^Fp       , Hh^Fp       , Hh          , Hh          , Gs^Fms      , Cv          , Cv          , Gg^Efm      , Gs^Fds      , Hh          , Gs^Fds      , Gg          , Gs^Fds      , Gs^Fds
Gs^Fds      , Hh^Fds      , Gs          , Hh^Fds      , Hh          , Wwf         , Wo          , Ww          , Wo          , Ww          , Ww          , Hh^Fds      , Gs^Fds      , Gg          , Hh          , Gg          , Gs^Fds      , Gg          , Gs^Fds      , Wwf         , Wwf         , Wo          , Wwf         , Hh          , Hh^Fms      , Hh^Fms      , Rd          , Rd          , Rd          , Rd          , Hh          , Hh          , Hh^Fp       , Hh^Fp       , Hh^Fms      , Hh          , Gg          , Gs^Fds      , Kv          , Gg^Efm      , Gs^Fds      , Gs^Fds      , Gg^Efm      , Gs^Fds      , Gs^Fds      , Gs^Fds
Gs^Fds      , Gs^Fds      , Gs          , Gs          , Rp          , Chw         , Wo          , Ww          , Wo          , Wo          , Ww          , Gs^Fds      , Wo          , Wo          , Gs^Fds      , Gs^Fds      , Gs^Fds      , Gg          , Gg          , Wwf         , Hh          , Wwf         , Gs^Fds      , Gs^Fms      , Hh^Vhh      , Re          , Re          , Rd          , Hh^Fms      , Hh          , Mm          , Mm          , Mm          , Hh          , Hh          , Gg          , Hh^Fms      , Gg^Efm      , Gg^Efm      , Gg^Efm      , Gs^Fds      , Gs^Fds      , Gg^Efm      , Gg^Ve       , Gs^Fds      , Gs^Fds
Gs^Fms      , Gs^Fds      , Gs^Fds      , Gs^Fds      , Rp          , Gs^Fds      , Gs^Fds      , Wo          , Ww          , Ww          , Wo          , Ww          , Ww          , Wo          , Chw         , Khw         , Wo          , Wo          , Gg          , Gs^Fds      , Hh^Fds      , Gg          , Gs^Fds      , Gg          , Re          , Re          , Re          , Hh^Fms      , Hh^Fms      , Hh          , Hh          , Mm          , Hh          , Hh          , Hh^Fms      , Hh          , Hh^Fms      , Hh          , Gs^Fms      , Cv          , Gg          , Gs^Fds      , Gs^Fds      , Gg^Efm      , Gs^Fds      , Gs^Fds
Gs^Fms      , Gs^Fms      , Rp          , Rp          , Rp          , Gs^Fds      , Gs^Fds      , Wo          , Wo          , Wo          , Wo          , Ww          , Ww          , Ww          , Wo          , Chw         , Ww          , Ww          , Ww          , Hh          , Gs^Fds      , Hh^Fds      , Gg          , Gs^Fds      , Rd          , Re          , Gs^Fms      , Hh^Fms      , Hh^Fms      , Chr         , Hh^Fms      , Hh^Fp       , Hh          , Chr         , Hh^Fms      , Hh          , Hh^Vc       , Hh          , Hh^Fp       , Gs^Fms      , Gg          , Gg          , Gs^Fds      , Gg^Efm      , Gs^Fds      , Gs^Fds
Hh^Fms      , Hh          , Hh          , Chr         , Chr         , Rp          , Gs          , Gs^Vht      , Gs^Fds      , Ww          , Gs^Fds      , Wo          , Wo          , Wwf         , Wo          , Wo          , Ww          , Wo          , Ww          , Ww          , Gs^Fds      , Gs^Fds      , Rd          , Rd          , Rd          , Rd          , Gs^Fms      , Hh^Fms      , Hh          , Kh          , Hh          , Hh          , Mm          , Hh^Fp       , Hh^Fp       , Hh^Fms      , Hh^Fms      , Hh          , Gs^Fms      , Gs^Fms      , Gg          , Gs^Fms      , Gs^Fds      , Gs^Fds      , Gs^Fds      , Gs^Fds
Hh^Fp       , Hh^Fms      , Hh          , Khr         , Chr         , Gs^Fds      , Gs          , Gs          , Gs          , Gs          , Gs          , Gs          , Gs^Fds      , Wwf         , Wwf         , Wo          , Wo          , Wo          , Wo          , Ww          , Ww          , Wwf         , Rd          , Rd          , Gs^Fds      , Gs^Fms      , Gs^Fms      , Hh          , Hh          , Hh          , Hh          , Mm          , Mm          , Mm          , Hh^Fp       , Hh^Fms      , Hh^Fms      , Gs^Fms      , Hh^Fms      , Gs^Fms      , Gs^Fms      , Gg          , Gs^Fms      , Hh^Fds      , Gs^Fds      , Gs^Fds
Hh^Fp       , Hh^Fms      , Hh          , Hh^Vhh      , Chr         , Gs^Fms      , Gs^Fms      , Gs^Fms      , Gs          , Gs^Fds      , Gs          , Gs^Fds      , Gs^Vht      , Gs          , Gs          , Gs          , Ww          , Wo          , Wo          , Ww          , Wwf         , Wwf         , Wwf         , Hh^Fds      , Gs^Fds      , Gs^Fds      , Gs^Fds      , Gs^Fms      , Hh          , Hh          , Hh          , Hh^Fms      , Hh^Fp       , Hh^Fp       , Mm          , Hh^Fms      , Hh^Fms      , Hh^Fms      , Hh^Fms      , Hh^Fms      , Gs^Fms      , Gs^Fms      , Gs^Fms      , Gs^Fds      , Gs^Fms      , Gs^Fds
Hh^Fp       , Hh^Fp       , Hh^Fms      , Hh          , Hh          , Hh          , Hh          , Hh          , Hh          , Gs          , Gs          , Gs^Fds      , Gs          , Gs          , Gs          , Ce          , Ce          , Ww          , Ww          , Wo          , Wwf         , Wwf         , Ww          , Gg          , Gg          , Gg          , Gg          , Gg          , Gs^Fms      , Hh^Vhh      , Hh          , Hh^Fms      , Hh          , Mm          , Mm          , Mm          , Hh^Fp       , Hh^Fms      , Hh^Fp       , Hh^Fms      , Gs^Fms      , Gg          , Gg          , Gg          , Gs^Fms      , Gs^Fms
Hh^Fp       , Hh^Fp       , Hh^Fp       , Hh^Fp       , Hh          , Hh^Vhh      , Hh          , Hh          , Hh          , Gs          , Gs^Fds      , Gs          , Gs^Fds      , Gs          , Gs          , Gs          , Ke          , Rd          , Rd          , Wwf         , Wwf         , Wo          , Wo          , Ww^Vm       , Ww          , Gg          , Gs^Fds      , Gg          , Gs^Fms      , Hh          , Hh          , Hh          , Khr         , Hh          , Hh^Fms      , Hh^Fp       , Mm          , Hh^Fp       , Hh^Fp       , Hh^Fms      , Hh^Fms      , Gs^Fms      , Gg          , Gg^Fet      , Gg          , Gs^Fms
Mm          , Hh^Fp       , Hh^Fp       , Hh^Fp       , Hh^Fms      , Hh^Fms      , Hh          , Hh          , Hh          , Hh          , Gs^Fms      , Gs^Fms      , Gs^Fms      , Gs^Vht      , Gs          , Gs          , Ce          , Ce          , Rd          , Wwf         , Ww          , Ww          , Wo          , Wo          , Wo          , Gg          , Gg          , Gg          , Gs^Fds      , Gg          , Hh          , Hh          , Hh          , Chr         , Hh^Fms      , Mm          , Mm          , Mm          , Hh^Fp       , Hh^Fp       , Hh^Fms      , Hh^Fms      , Gs^Fms      , Gs^Fms      , Gg          , Gs^Fms
Mm          , Mm^Xm       , Mm^Xm       , Hh^Fp       , Hh^Fp       , Hh          , Hh^Fp       , Hh          , Hh          , 5 Hh        , Hh          , Hh^Fms      , Rd          , Gs^Fms      , Rd          , Gs          , Rd          , Rd          , Gs          , Ce          , Ce          , Ww          , Ww          , Wo          , Wo          , Gs^Fds      , Gg          , Gs^Fds      , Gg          , Gg          , Gg          , Hh^Fms      , Hh          , Hh^Fms      , Hh^Fms      , Hh^Fms      , Hh^Fms      , Hh^Fp       , Hh^Fp       , Hh^Fp       , Hh^Fms      , Hh^Fms      , Hh^Fms      , Gs^Fms      , Hh^Fms      , Gg
Mm          , Mm          , 1 Mm        , Mm^Xm       , Hh^Fp       , Hh^Fp       , Hh          , Hh^Fp       , Hh          , 3 Hh        , 2 Rd        , Rd          , Hh^Vhh      , Rd          , Hh          , Rd          , Rd          , Gs^Fds      , Gs          , Gs          , Gs^Fds      , Ww          , Wo          , Wo          , Ww          , Ww          , Gs^Fds      , Gg          , Gs^Fds      , Gs^Fds      , Gs^Fms      , Hh^Fms      , Hh          , Hh^Fms      , Hh          , Hh^Fms      , Chr         , Hh^Fp       , Mm          , Mm          , Mm          , Hh^Fms      , Hh^Fms      , Hh^Fms      , Hh^Fms      , Hh^Fms
Hh          , Mm          , Mm          , Mm^Xm       , Hh          , Hh          , Hh          , Hh^Fp       , Hh          , 4 Hh        , Rd          , Hh^Fms      , Hh^Fp       , Hh          , Hh^Fms      , Hh          , Rd          , Gs^Fms      , Gs^Fds      , Gs          , Gs          , Ww          , Wo          , Ww          , Ww          , Hh          , Gs^Fds      , Gg          , Gg          , Gg          , Gg          , Gs^Fms      , Gg          , Hh          , Hh          , Hh          , Chr         , Hh^Fms      , Hh^Fp       , Mm          , Hh^Fp       , Hh^Fp       , Hh^Fp       , Hh^Fms      , Hh^Fms      , Hh^Fms
Hh          , Mm          , Mm          , Mm^Xm       , Hh          , Hh          , Hh          , Hh          , Hh          , Hh          , Hh          , Rd          , Hh          , Hh^Fms      , Hh^Fms      , Gs^Fms      , Rd          , Gs          , Gs          , Gs          , Gs          , Ww          , Wo          , Wo          , Wo          , Wo          , Ww          , Gs^Fds      , Gg          , Gg          , Gs^Fds      , Gg          , Gg          , Gg          , Hh          , Hh          , Hh          , Hh          , Hh          , Hh^Fp       , Hh^Fp       , Hh^Fp       , Hh^Fp       , Hh^Fp       , Hh^Fms      , Hh^Fms
