border_size=1
usage=map

Xu          , Xu          , Xu          , Xu          , Xu          , Xu          , Xu          , Xu          , Rr          , Xu          , Xu          , Xu          , Xu          , Uh          , Uu^Uf       , Uu^Uf       , Rb          , Rb^Br|      , Uu^Uf       , Uu^Uf       
Xu          , 1 Kud       , Xu          , Xu          , Uh          , Xu          , Uh^Vud      , Xu          , Rr          , Xu          , Uh          , Cud         , Uh          , Uh          , Uu^Uf       , Uu^Uf       , Rb^Br|      , Rb^Br/      , Uu^Uf       , Uu^Uf       
Rb          , Xu          , Uh          , Uh          , Uh          , Uh          , Uh          , Uh          , Uh          , Rr          , Rr          , Uh          , Uh          , Uh          , Uu^Uf       , Rb^Vud      , Rb^Br|      , Uu^Uf       , Uu^Uf       , Uu^Uf       
Uh          , Rb          , Rb          , Rb          , Rb          , Re          , Re          , Uh          , Uh          , Uh          , Rr          , Uh          , Uh          , Uu^Uf       , Rb          , Rb          , Rb^Br|      , Uu^Uf       , Uu^Uf       , Uu^Uf       
Uh          , Uu          , Uu          , Uu          , Rb          , Re          , Rb          , Re          , Rb          , Rr          , Cud         , Rr          , Re          , Re          , Rb^Br/      , Rb^Br/      , Uu^Uf       , Uu^Uf       , Uu^Uf       , Uu^Uf       
Ql          , Uh^Vu       , Uh          , Uu          , Rb          , Rb          , Re          , Re          , Rb          , Re          , Re          , Rb          , Re          , Rb^Br|      , Uu          , Cud         , Uu^Uf       , Uu^Uf       , Uu^Uf       , Uh          
Ql          , Ql          , Ql          , Uu          , Rb          , Re          , Re          , Rb          , 4 Rb        , Rb          , 2 Re        , Rb          , Rb          , Rb^Br|      , Uu          , Uu          , Uu          , Uh          , Uh          , Uh          
Xos         , Ql          , Ql          , Ql          , Ql          , Rb          , Rb          , 5 Re        , Rb          , Re          , Re          , 3 Rb        , Rb          , Rb^Br|      , Uue         , Uu^Vud      , Urb         , Uh          , Uh          , Uh          
Xos         , Urb         , Urb         , Ql          , Ql          , Rb          , Uue         , Uu          , Uu          , Rb          , Uu          , Rb          , Rb          , Rb^Br|      , Uue         , Uu          , Urb         , Cud         , Ql^Xo       , Ql^Xo       
Urb         , Urb         , Urb         , Ql          , Ql          , Uue^Vu      , Uue         , Uu          , Uue         , Uu          , Uu          , Uu          , Rb          , Rb^Br|      , Urb         , Uue         , Uue         , Ql^Xo       , Ql^Xo       , Ql^Xo       
Urb         , Urb         , Xos         , Urb         , Urb         , Ql          , Ql          , Uue         , Uue         , Uue         , Uue         , Uu          , Urb         , Urb^Br|     , Cud         , Uue         , Ql^Xo       , Ql^Xo       , 6 Uue       , Uue         
Xos         , Xos         , Xos         , Xos         , Xos         , Urb         , Ql          , Ql          , Uue         , Uue         , Uue         , Uue         , Urb         , Urb^Br|     , Urb^Br\     , Ql^Xo       , Ql^Xo       , Ql^Xo       , Uue         , Uue         
