border_size=1
usage=map

Rp, Rp, Rp, Gs^Fds, Hh^Fms, Hh^Fms, Hh^Fms, Hh^Fms, Hh^Fms, Hh^Fp, Hh^Fp, Hh^Fp, Hh^Fp, Hh^Fp, Hh^Fp, Mm^Xm, Mm^Xm, Mm^Xm, Mm^Xm, Mm^Xm, Mm^Xm, Mm^Xm, Mm^Xm, Mm^Xm, Mm^Xm, Mm, Mm, Ww, Ww, Ww, Wo, Ww, Hh, Mm, Mm, Mm, Mm, Mm, Mm, Mm^Xm, Xu, Xu, Xu, Xu, Xu, Xu, Xu, Xu, Xu, Xu, Xu, Xu, Xu, Xu, Xu, Xu, Xu, Xu, Xu, Xu, Xu, Xu, Xu, Xu, Xu
Gs^Fds, Rp, Rp, Rp, 4 Gg, Gs^Fds, 5 Gg, Hh^Fds, Hh^Fds, Hh^Fp, Hh^Fms, Hh^Fp, Ce^Vct, Hh^Fp, Ce, Hh^Fp, Hh^Fp, Mm^Xm, Mm^Xm, Mm^Xm, Mm^Xm, Mm^Xm, Mm^Xm, Mm^Xm, Mm^Xm, Mm, Mm, Wo, Wo, Ww, Wo, Ww, Hh, Mm, Mm, Mm, Mm, Mm, Mm^Xm, Mm^Xm, Xu, Xu, Xu, 1 Kud, Xu, Xu, Xu, Xu, Xu, Xu, Xu, Xu, Xu, Xu, Uu^Uf, Xu, Xu, Xu, Xu, Xu, Uh, Xu, Uh, Xu, Xu
Gs^Fds, Rp, 2 Rp, 3 Rp, Rp, Gg, Gs^Fds, Hh^Fds, Hh^Fds, Hh^Fds, Ce, Ce, Ww, Ce, Ce, Ce^Vct, Hh^Fp, Mm, Mm, Mm, Mm^Xm, Mm^Xm, Mm, Mm^Xm, Mm, Mm, Mm, Ww, Ww, Wo, Hh, Hh, Hh, Hh, Md, Mm, Mm, Mm^Xm, Xu, Mm^Xm, Xu, Xu, Xu, Xu, Uu^Vud, Uu, Uu, Uu, Uu, Xu, Xu, Uu^Uf, Uu^Vud, Uu^Uf, Uu, Uu, Uu, Uu^Uf, Uu, Uu^Vu, Ur, Uu^Uf, Ur, Uh, Xu
Gs^Fds, Gs^Fds, Rp, Rp, Rp, Rp, Ce, Ce, Ce, Ce, Ce, Ce, Ww, Wo, Ww, Ce, Mm, Mm, Mm, Mm, Mm, Mm, Mm, Mm, Mm, Mm, Mm, Ww, Ww, Wo, Wo, Ww, Hh, Hh, Hh, Mm, Mm, Mm^Xm, Xu, Xu, Uh, Uu, Uu, Uu, Urb, Urb, Urb, Uu^Vud, Urb, Xu, Xu, Uu^Uf, Uu^Uf, Cud, Cud, Cud, Rb, Rb, Rb, Uu, Xu, Ur, Uu^Vu, Ur, Xu
Hh^Fds, Gs^Fds, Gs^Fds, Rp, Rp, Rp, Ce^Vct, Ce, Iwr, Iwr, Iwr, Ce, Ce^Vct, Wo, Ww, Ww, Wo, Mm, Mm, Mm, Mm, Mm, Mm, Mm, Hh, Hh^Vhh, Wo, Wo, Wo, Wo, Ww, Ww, Hh, Hh, Hh, Mm, Mm^Xm, Mm^Xm, Xu, Uh, Uu, Uu, Urb, Uu, Urb, Urb, Urb, Urb, Urb, Urb, Cud, Uu, Uu, Uu, Cud, Cud, Cud, Xu, Xu, Xu, Xu, Xu, Uh, Uh, Xu
Hh^Fds, Gs^Fds, Gs^Fds, Gs^Fds, Gs^Fds, Rp, Ce, Iwr, Iwr, Iwr, Iwr, Ce, Ce, Ce, Ww, Wo, Ww, Mm, Hh^Vhh, Mm, Hh, Hh, Hh, Hh, Ww, Ww, Wo, Ww, Wo, Wo, Ww, Hh, Hh^Vhh, Hh, Hh, Mm, Mm^Xm, Xu, Uh, Uh, Uh, Uu^Vud, Urb, Urb, Urb, Urb, Urb, Cud, Cud, Cud, Uu, Uu, Rb, Rb, Uu, Uu, Rb, Uu^Uf, Uu^Uf, Uu^Uf, Xu, Xu, Xu, Uh, Xu
Mm^Xm, Hh^Fds, Hh^Fds, Gs^Fds, Gs^Fds, Ce, Ce, Ce, Iwr, Iwr, Iwr, Iwr, Ce, Wwf, Wwf, Wo, Ww, Ww, Ww, Wo, Ww, Wo, Ww, Ww, Wo, Wo, Ww, Ww, Ww, Ww, Gs, Hh, Hh, Hh, Gs, Mm, Mm^Xm, Xu, Xu, Xu, Uh, Uh, Uh, Uh, Uu, Xu, Xu, Cud, Uu, Rb, Rb, Rb, Uh, Uu, Uh, Rb, Uu, Uu^Uf, Uu, Uu^Uf, Xu, Xu, Xu, Xu, Xu
Mm^Xm, Mm, Hh^Fds, Gs^Fds, Gs^Fds, Ce^Vct, Ce, Ce, Ce, Iwr, Ce, Ce^Vct, Wwf, Wwf, Wwf, Ww, Wwf, Ww, Wo, Wo, Ww, Wo, Ww, Wo, Wo, Ww, Ww, Wo, Gs, Ww, Gg, Hh, Gs, Hh, Gs, Mm, Mm, Mm^Xm, Mm^Xm, Xu, Xu, Xu, Xu, Uh, Xu, Xu, Xu, Rb, Uu, Uu, Xu, Rb^Vud, Xu, Xu, Uh, Uh, Uu, Rb, Uu, Xu, Xu, Xu, Xu, Xu, Xu
Mm^Xm, Mm^Xm, Mm, Hh^Fds, Gs^Fds, Ce, Ce, Ww, Ww, Ce^Vct, Ww, Ww, Wwf, Wwf, Wwf, Wwf, Ce, Ce^Vct, Ww, Ww, Wo, Wo, Gll, Ww, Gg^Vh, Ww, Gs, Ww, Gs, Gg, Gll, Gll, Gs, Gg, Gll, Gg, Mm, Mm, Mm^Xm, Xu, Mm^Xm, Xu, Mm^Xm, Xu, Xu, Xu, Xu, Uu, Uh, Uh, Xu, Xu, Xu, Xu, Xu, Uu^Uf, Uu^Uf, Uu, Rb, Uu^Vud, Xu, Xu, Xu, Xu, Xu
Mm^Xm, Mm^Xm, Mm, Hh^Fds, Hh^Fds, Gs^Fds, Ww, Ww, Wwf, Wwf, Ww, Ww, Wo, Ww, Wo, Ce, Md, Ce, Ww, Ww, Gg, Gg, Gs, Gg, Gg, Gs, Gg, Gs, Gs^Fds, Gll, Gg, Gs, Gg^Vhr, Gll, Gd, Gll, Gd, Mm, Md, Mm^Xm, Md, Mm^Xm, Md, Mm^Xm, Mm^Xm, Xu, Xu, Uu^Vu, Uh, Uh, Uh, Xu, Xu, Xu, Xu, Xu, Uh, Uu, Urb, Urb, Xu, Xu, Xu, Xu, Xu
Mm^Xm, Mm^Xm, Mm^Xm, Mm, Wo, Wo, Ww, Ww, Ww, Wwf, Ww, Ww, Wo, Wo, Wo, Ce, Ce, Ce, Wwf, Wwf, Ket, Gs, Gll, Gg, Gll, Gll, Gs^Fds, Gs^Fds, Gg, Gg, Gs^Fds, Gs^Fds, Gs^Fds, Gd, Ss, Gd, Ss, Mm, Ss, Md, Ss, Md, Md, Md, Md, Mm^Xm, Mm^Xm, Xu, Xu, Rb, Uu, Uh, Uh, Xu, Xu, Xu, Uu, Uu, Urb, Uh, Uh, Xu, Xu, Xu, Xu
Ww, Wo, Ww, Wo, Ww, Ww, Ww, Ww, Wwf, Wwf, Ww, Wo, Wo, Ww, Ww, Wo, Ww, Wwf, Wwf, Rr, Rr, Gg, Gs, Gll, Hh, Gg, Gg, Gs^Fds, Gg, Gs^Fds, Gs^Fds, Gs^Fds, Gs^Fds, Gd, Ss, Gd, Ss^Vhs, Ss, Ss, Ss, Sm, Sm, Sm, Md, Md, Md, Mm^Xm, Mm^Xm, Xu, Uu, Rb, Uu, Uh, Xu, Uh, Uh, Xu, Uu, Urb, Urb^Vud, Urb, Uh, Xu, Xu, Xu
Wo, Wo, Wo, Wo, Ww, Ww, Ww, Ww, Rr, Wwf, Gg, Gs, Gg, Ww, Gg^Vh, Ww, Wwf, Wwf, Ket, Rr, Rr, Rp, Rr, Gs, Hh, Hhd, Gg, Gs^Fds, Gs^Fds, Gs^Fds, Gg, Gll, Gs, Gd, Gd, Ss, Ss, Ss, Ss, Ss, Rb^Fdw, Sm, Sm, Md, Md, Md, Md, Mm^Xm, Mm^Xm, Xu, Rb, Uu, Uu, Uu, Xu, Xu, Xu, Ur, Uu, Urb, Uh, Uu, Xu, Xu, Xu
Wo, Ww, Ww, Wo, Ww, Ww, Ww, Ww, Rr, Gg, Gs, Gs, Gs, Gs, Gs, Gg, Gs, Gg, Gg, Gg, Gs, Rp, Rp, Rp, Rp, Gg, Gd, Gg, Gg, Gs^Fds, Gg, Gs^Fds, Hhd^Fds, Gll, Hhd^Fdw, Ss, Ss, Ss, Ss, Sm, Rb^Fdw, Sm, Rb^Fdw, Sm, Sm, Md, Md, Md, Mm^Xm, Xu, Uu, Uu, Uu, Rb, Uu, Xu, Xu, Ur, Uu, Uu^Uf, Uh, Xu, Uh, Xu, Xu
Ww, Wo, Hh, Ww, Hh^Vhh, Ww, Hh, Rr, Gs, Gs, Gg, Gs, Gg, Gll, Gll, Gll, Gs, Gg, Gs, Gg, Gg, Gs, Gll, Rp, Rr, Rp, Rp, Gs, Rp, Gg, Gs^Fds, Gs^Fds, Gll, Hhd^Fdf, Hhd^Fdf, Hhd^Fdw, Ss, Ss, Ss, Ss, Rb^Fdw, Rb^Fdw, Sm, Sm^Vhs, Sm, Md, Co, Md, Mm^Xm, Xu, Rb^Vo, Rb, Uu, Uu, Uh, Uh, Xu, Uu, Uu, Uu, Uu, Uh, Uu^Vu, Xu, Xu
Ww, Wo, Hh, Hh, Hh, Hh, Hh, Rr, Gs^Fds, Gg, Gs^Fds, Gs, Gll, Gg, Gs, Gll, Gs, Gg, Gll, Gs, Gg, Hh, Gg^Vh, Gll, Gs, Rr, Rr, Rr, Rr, Rp, Gll, Gg, Hhd, Hhd^Fdf, Gd, Ss, Ss, Ss, Ss, Sm, Ss, Rb^Fdw, Rb^Fdw, Rb^Fdw, Sm, Sm, Co, Co^Vo, Co, Xu, Rb, Rb, Uu, Uu, Rb, Uu, Ur, Ur, Ur, Ur, Rb, Uu, Xu, Xu, Xu
Hh, Hh^Fp, Hh^Fp, Hh, Hh, Hh, Rr, Rr, Gs^Fds, Gs^Fds, Gll, Gs^Fds, Gg^Ve, Gs, Gs^Fds, Gs, Gs, Gs^Fds, Gll, Gg, Gs^Fds, Gs, Gg, Gg, Gs, Gd, Hh, Rp, Rr, Rp, Rp, Gg, Gg, Hhd, Gg, Gd, Ss, Ss, Ss, Sm, Ss, Sm, Sm, Sm, Ko, Sm, Sm, Co, Rb, Rb, Rb, Rb, Xu, Rb, Uu, Uu, Uh, Ur, Uh, Ur, Xu, Xu, Xu, Xu, Xu
Hh, Hh^Fp, Hh^Fp, Hh^Fp, Gs^Fds, Rr, Rp, Gs^Fds, Gs^Fds, Gll, Gg, Gg, Gg, Gg, Hh^Fds, Gs, Gs^Fds, Gs, Gll, Gs^Fds, Gs, Gg, Gs^Fds, Gs^Fds, Gs^Fds, Gd, Gg, Hh, Rp, Rp, Rp, Gs^Fds, Gg, Gs^Fds, Gs^Fds, Gd, Gd, Ss, Ss, Ss, Rb, Sm, Rb, Rb, Re, Re, Rb, Rb, Rb, Rb, Rb^Vo, Co, Xu, Rb, Xu, Uu, Uh, Uh, Uh, Ur, Uu, Uh, Xu, Xu, Xu
Hh, Hh, Hh^Fp, Hh^Fp, Hh^Vhh, Rp, Hh, Gs^Fds, Gs^Fds, Gs^Fds, Gs^Fds, Gs^Fds, Gs^Fds, Gs^Fds, Hh^Fds, Hh^Fds, Gs^Fds, Gll, Gs^Fds, Gs, Gs, Gs, Gs^Fds, Gs^Fds, Gg, Gg, Gs^Fds, Gg, Rr, Rp, Rp, Gg, Gs^Fds, Gg, Gs^Fds, Gg, Gg^Vhr, Ss, Ss, Ss, Rb, Re, Re, Re, Ko, Re, Rb, Rb, Sm, Co, Co, Co, Co, Xu, Uu^Vu, Rb, Rb, Uu, Ur, Ur, Ur, Uu^Vu, Uu^Uf, Xu, Xu
Hh, Hh, Hh^Fp, Hh^Fms, Hh^Fms, Rp, Rr, Gs^Fds, Gs^Fds, Gs^Fds, Gg, Gg, Gg, Gg, Gs^Fds, Hh^Fds, Gs^Fds, Gll, Gll, Gs, Gs^Fds, Gg, Gs^Fds, Gs^Fds, Gg, Gs, Gs, Gg, Rp, Rr, Rp, Gg, Rb, Rb, Rb, Rb, Rb, Re, Rb, Rb, Re, Rb, Rb, Rb, Re, Rb, Sm, Ko, Sm, Sm, Sm, Sm, Co, Xu, Uh, Rb, Uh, Xu, Xu, Ur, Rb, Ur, Xu, Xu, Xu
Hh, Hh, Hh, Hh^Fms, Hh^Fms, Hh, Rp, Hh^Fds, Hh^Fds, Gs^Fds, Gs^Fds, Gg^Ve, Gs^Fds, Gll, Gs^Fds, Gs^Fds, Gs^Fds, Gs^Fds, Gs^Fds, Gll, Gs, Gs, Gs, Gg, Gg, Gs, Gg, Gll, Gs^Vhr, Rp, Rp, Ce, Ce, Rb, Re, Re, Rb^Vhr, Rb, Re, Rb, Ss, Rb, Ss, Ss, Ss, Sm, Sm, Sm, Sm, Sm, Rb^Fdw, Sm, Sm^Uf, Xu, Xu, Uh, Xu, Xu, Xu, Ur, Rb, Xu, Xu, Xu, Xu
Hh, Hh^Fms, Hh^Fms, Hh^Fms, Hh^Fms, Rp, Hh^Fds, Gs^Fds, Hh^Fds, Hh^Fds, Hh^Fds, Gs^Fds, Gg, Gll, Cv, Cv, Cv, Gg, Gs^Fds, Gs^Fds, Gs^Fds, Gll, Gll, Gll, Gs^Fds, Gs, Gs, Gll, Gg, Rp, Rp, Rr, Rp, Rd, Rb, Rb, Re, Rb, Rb, Rb, Gg, Ss, Gg, Ss, Sm, Sm, Sm, Sm, Rb^Fdw, Sm, Rb^Fdw, Sm, Sm, Xu, Xu, Xu, Xu, Xu, Xu, Rb, Rb, Rb^Uf, Xu, Xu, Xu
Hh, Hh^Fms, Hh^Fms, Hh, Hh^Fms, Rp, Rp, Hh^Fds, Gs^Fds, Gs^Fds, Gs, Gs, Gg, Gg^Ve, Gs^Fds, Cv, Cv, Gs^Fds, Kv, Gs, Gs, Gs, Gs^Fds, Hh, Gs, Gll, Gg, Gs, Gs, Gg, Ce, Rr, Rp, Rd, Rd, Re, Re, Re, Gs^Fds, Gs^Fds, Gs^Fds, Gg, Gg, Ss, Ss, Sm, Sm, Sm^Vhs, Rb^Fdw, Rb^Fdw, Sm, Sm, Rb, Xu, Sm^Uf, Xu, Xu, Xu, Sm^Uf, Sm, Sm, Sm, Sm, Sm^Uf, Rb^Fdw
Hh^Fms, Hh^Fms, Hh, Hh, Hh^Fms, Hh^Fds, Rr, Hh, Hh^Fds, Hh^Fds, Hh^Fds, Gs^Ve, Gs, Gs, Gs, Gs, Cv, Gs^Fds, Gs^Fds, Gg, Gll, Gll, Gs, Hh, Hh^Fds, Gs, Gg, Gg, Hh, Hhd, Ce, Rp, Rr, Rp, Rr, Rd, Re, Gll^Vhr, Gll, Gs^Fds, Gs^Fds, Gg, Gg, Gg, Ss, Sm, Gs^Fdf, Rb^Fdw, Sm, Rb^Fdw, Sm, Sm^Uf, Rb^Fetd, Sm, Sm, Sm, Sm^Uf, Sm, Sm, Sm, Rb^Fdw, Sm, Sm^Uf, Rb^Fetd, Sm
Hh, Hh^Fms, Hh, Hh^Vhh, Hh, Hh^Fms, Rp, Gs^Fds, Gs^Fds, Hh^Fds, Gs^Fds, Gs, Gs, Gs, Gs^Fds, Cv, Gs^Ve, Gs^Fds, Gs^Fds, Gg, Kv, Gg, Gs^Fds, Gs^Fds, Gg, Gs^Fds, Gg, Gs, Gs, Hhd, Gs, Ce, Rp, Rr, Rd, Rd, Re, Gll, Gg, Gg, Gs^Fds, Gs^Fds, Gs^Fds, Gg, Gs^Fds, Gs^Fds, Gs^Fdf, Gs^Fdf, Sm, Sm, Sm, Sm, Sm, Rb, Sm^Uf, Sm, Sm^Vhs, Sm, Sm^Uf, Rb^Fdw, Sm, Rb^Fdw, Sm, Rb^Fdw, Sm
Hh, Hh, Hh^Fms, Hh^Fms, Hh, Rp, Gll^Fp, Gs^Fds, Hh^Fds, Gs^Fds, Hh^Fds, Gs, Gs, Gs, Gs, Cv, Gs^Fds, Gs, Gg, Gs^Fds, Gll, Gs, Gs^Fds, Gg, Gg, Gs^Fds, Gs^Fds, Gs, Gs, Gs, Rp, Rr, Rp, Rr, Rp, Rd, Gll, Gll, Gg, Gs^Fds, Gs^Fds, Gs^Fds, Gs^Fds, Gs^Fds, Gg, Gs^Fds, Gs^Fds, Gs^Fdf, Ss, Sm, Ss, Sm, Sm, Sm, Sm, Sm, Sm, Sm, Rb^Fdw, Rb^Fdw, Sm, Rb^Fdw, Sm, Sm, Sm
Hh, Hh, Hh^Fms, Hh, Hh, Rp, Gll^Fp, Hh^Fds, Hh^Fp, Hh^Fms, Hh^Fds, Hh^Fds, Gs^Fds, Gs^Ve, Gs, Gs^Fds, Gs^Fds, Gs^Fds, Gg, Gg^Ve, Gg, Gg, Gs, Gs^Fds, Gs, Gg, Gs^Fds, Gs, Gll, Gg, Rp, Rp, Rp, Rp, Gs, Rd, Gll, Gg, Gg, Gs^Fds, Gll, Gll, Gs^Fds, Gs^Fds, Gg, Gs^Fds, Gg, Ss, Gg, Ss, Gd, Gd, Hhd, Sm, Hhd, Rb, Hhd, Sm, Rb^Fdw, Rb^Fdw, Sm, Sm, Hhd, Sm, Hhd
Hh, Hh^Fms, Hh^Fms, Hh, Rp, Rp, Gll^Fp, Hh^Fp, Gll^Fp, Hh^Fds, Hh^Fds, Hh, Wwf, Gs^Fds, Hh, Gs, Wwg, Gg, Gs^Fds, Gg, Gs^Fds, Gs^Fds, Gg, Gs, Gll, Gll, Gs^Fds, Gg, Gg, Gg, Rp, Rp, Rr, Rr, Gs, Gs, Gg, Gg, Gg, Gg, Gll, Gs^Fds, Gs, Gg, Gg, Gll, Gg, Ss, Gs, Gd, Gd, Gd, Hhd, Hhd, Hhd, Rb, Md, Md, Md, Hhd, Hhd, Hhd, Hhd, Hhd, Hhd
Hh, Hh, Hh, Rr, Hh, Gll^Fp, Gll^Fp, Gll^Fp, Gll^Fp, Wwf, Hh, Hh, Wwf, Hh, Wwf, Hh, Gs^Fds, Gs^Fds, Wwg, Gs^Fds, Wwg, Gs, Gs, Gg, Gll, Gg, Gg, Gs^Fds, Gg, Gg, Rp, Rr, Rp, Gg, Gg, Gg, Gs^Fds, Gg, Gs^Fds, Gg, Gg, Gs, Gs, Gs, Gs^Vc, Gll, Gs, Gd, Gs, Gd, Hhd, Hhd, Hhd^Vhh, Hhd, Md, Re, Rd, Md, Md, Md, Md, Hhd, Hd, Hhd, Dd
Md, Md, Hh, Rr, Hh, Hh, Gll^Fp, Hh^Fp, Gll^Fp, Wwf, Wwf, Wwf, Ur, Hh, Hh, Hh, Gs^Fds, Wwg, Gs^Fds, Wwg, Wwg, Gs, Gs^Fds, Gs, Gs^Fds, Gs, Gs^Fds, Gs^Fds, Gs, Gg, Rr, Rr, Rp, Rp, Gs^Fds, Gs^Fds, Gs^Fds, Gg, Gs^Fds, Gs^Fds, Gs, Gll, Gs, Gll, Gs, Rd, Gs, Gs, Gd, Gd, Gd, Hhd, Hhd, Md, Md, Md, Rd, Hhd, Md, Md, Md, Dd, Hd, Hd, Hd
Md, Md, Hh, Rr, Rr, Hh, Gll^Fp, Hh^Fp, Gll^Fp, Hh, Hh, Wwf, Hh, Ur, Hh, Wwf, Wwf, Gs^Fds, Gs^Fds, Gs^Fds, Gs^Fds, Wwg, Gs^Fds, Gs^Fds, Gs^Fds, Gs^Fds, Gs^Fds, Gs, Gd, Gd, Rr, Rp, Rr, Gs^Fds, Gs^Fds, Gs^Fds, Gs^Fds, Gs^Fds, Gs^Fds, Gs^Fds, Gs, Gg, Gs, Gs, Re, Re, Gd, Gs, Re, Gd, Rd, Hhd, Hhd, Md, Md, Md, Rd, Hhd, Md, Md, Md, Md, Rd, Hd, Dd
Md, Md, Md, Hh^Vhhr, Rr, Hh, Hh^Fp, Gll^Fp, Gll^Fp, Gll^Fp, Hh^Fp, Hh, Hh, Hh, Wwf, Hh, Gs^Fds, Gs^Fds, Wwf, Wwf, Wwf, Gs^Fds, Wwg, Gs^Fds, Hh, Gs^Fds, Gs, Gll, Gs^Vht, Gd, Rr, Rr, Rr, Gs^Fds, Gs^Fds, Gs^Fds, Gs^Fds, Gs^Fds, Re, Gs^Fds, Gd, Gs, Gs, Rd, Gd, Gd, Re, Re, Re, Gd, Rd, Hhd, Hhd, Md, Md, Md, Hhd, Rd, Md, Md, Dd, Dd^Vda, Dd, Dd, Dd
Md, Md, Md, Rr, Chr, Hh, Hh^Fp, Hh^Fp, Hh^Fp, Gll^Fp, Hh^Fp, Hh, Gll^Fp, Wwf, Wwf, Hh, Gs^Fds, Wwf, Wwg, Wwg, Wwg, Wwg, Wwg, Gs^Fds, Gd, Gd, Gll, Gll, Gd, Rr, Rr, Rr, Hhd, Gd, Gs^Fds, Gs^Fds, Gd, Gs^Fds, Re, Re, Re, Re, Gs, Rd, Gd, Gd, Re, Gd, Re, Rd, Hd, Dd, Dd, Md, Md, Md, Hhd, Rd, Rd, Md, Dd, Dd, Rd, Dd, Dd
Md, Mm^Xm, Md, Md, Md, Chr, Md, Hh^Fp, Hh^Fp, Gll^Fp, Gll^Fp, Gll^Fp, Gll^Fp, Hh, Hh, Hh, Gs^Fds, Wwf, Wwg, Gs^Fds, Hh, Gs^Fds, Gs^Fds, Gs^Fds, Gs^Fds, Hh, Hh, Gd, Hhd, Rr, Rr, Rr, Hhd, Gd, Gs^Fds, Gs^Fds, Gd, Gs^Fds, Re, Re, Gd, Gd, Gd, Gd, Gs, Gs, Gd, Rd, Rd, Rd, Dd, Dd, Dd, Dd, Md, Md, Hd, Dd, Hd, Rd, Dd, Dd, Hd, Rd, Dd
Mm^Xm, Mm^Xm, Mm^Xm, Md, Md, Chr, Chr, Chr, Hh, Gll^Fp, Hh^Fp, Gll^Fp, Hh^Fp, Gll^Fp, Hh, Hh, Wwg, Wwg, Gs^Fds, Hh, Gs^Fds, Gs^Fds, Wwg, Gs^Fds, Hh, Hh, Hh, Gd, Hhd, Hhd, Hhd, Rr, Rr, Hhd, Hhd, Rd, Rd, Rd, Rd, Kd, Rd, Gd, Cd, Gd, Cd, Cd, Cd, Rd, Cd, Dd, Dd, Dd, Dd, Dd, Dd, Dd, Dd, Hd, Hd, Hd, Dd, Dd, Hd, Dd, Rd
Md, Mm^Xm, Mm^Xm, Mm^Xm, Mm^Xm, Md, Md, Chr, Hh, Hh, Hh^Fp, Hh^Fp, Hh^Fp, Hh^Fp, Wwg, Wwg, Hh, Hh, Wwg, Hh, Hh, Wwg, Wwg, Hh, Hh, Gs^Fds, Hh, Hh, Hh, Hhd, Hhd, Rr, Rr, Hhd, Rr, Hhd, Rd, Rd, Rd, Rd, Rd, Gd, Cd, Cd, Rd, Rd^Vda, Rd, Cd, Cd, Dd, Dd, Dd^Vdt, Dd, Dd, Dd, Dd, Dd, Hd, Hd, Dd, Rd, Dd, Dd, Rd, Dd
Md, Md, 6 Kud, Mm^Xm, Mm^Xm, Mm^Xm, Md, Hh^Vhhr, Md, Hh, Hh, Gll^Fp, Gll^Fp, Hh^Fp, Hh^Fp, Hh, Hh, Hh, Hh, Hh^Vhh, Hh, Wwg, Wwg, Hh, Hh, Hh, Hh, Hh, Hh, Hhd, Md, Hhd, Hhd, Rr, Hhd, Rr, Rd, Rd, Kd, Rd, Rd, Cd, Cd, Cd, Rd^Vda, Rd, Rd^Vda, Cd, Dd, Dd, Dd, Dd, Dd, Dd, Dd, Dd, Dd, Hd, Dd, Dd, Dd, Rd, Rd, Rd, Dd
Md, Md, Hh, Mm^Xm, Mm^Xm, Mm^Xm, Mm^Xm, Md, Md, Md, Hh, Gll^Fp, Gll^Fp, Gll^Fp, Gll^Fp, Hh, Hh, Wwg, Wwg, Wwg, Wwg, Hh, Wwf, Wwf, Wwg, Hh, Wwf, Hh, Hhd, Hhd, Md, Md, Hhd, Hhd, Rd, Hhd, Rd, Rd, Dd, Rd, Dd, Cd, Rd^Vda, Rd, Rd, Rd, Cd, Cd, Dd, Dd, Dd^Vdt, Dd, Dd, Dd, Dd, Dd, Dd, Dd, Dd, Dd, Dd, Hd, Dd, Dd, Dd
Md, Md, Mm^Xm, Mm^Xm, Mm^Xm, Mm^Xm, Mm^Xm, Mm^Xm, Mm^Xm, Md, Hh, Gll^Fp, Gll^Fp, Gll^Fp, Gll^Fp, Hh, Hh, Hh, Hh, Hh, Hh, Hh, Wwf, Wwg, Hh, Hh, Wwf, Wwf, Hhd, Hhd, Md, Hhd, Hhd, Hhd, Rd, Rd, Dd, Dd, Dd, Dd, Dd, Cd, Cd, Rd, Rd^Vda, Rd, Cd, Rd, Dd, Dd, Rd, Rd, Dd, Dd, Rd, Rd, Dd, Rd, Hd, Hd, Dd, Dd, Dd, Dd, Dd
Md, Md, Md, Mm^Xm, Mm^Xm, Mm^Xm, Mm^Xm, Mm^Xm, Mm^Xm, Hh, Hh, Hh, Hh, Hh^Vhhr, Hh, Gll^Fp, Gll^Fp, Hh, Hh, Hh, Wwg, Wwg, Wwg, Hh, Hh, Hh, Wwf, Wwg, Hhd, Md, Hhd, Hhd, Hhd, Rd, Dd, Dd, Dd, Dd, Dd, Dd, Dd, Cd, Rd, Cd, Cd, Cd, Rd, Rd, Kd, Dd, Dd, Dd, Dd, Dd^Vdt, Dd, Dd, Dd, Hd, Dd, Dd, Dd, Dd, Dd, Dd, Dd
Md, Md, Md, Md, Md, Md, Mm^Xm, Mm^Xm, Mm^Xm, Md, Md, Md, Md, Md, Hh, Gll^Fp, Gll^Fp, Hh, Gll^Fp, Wwg, Gll^Fp, Hh, Hh, Hh, Wwf, Wwf, Wwg, Hhd, Md, Md, Dd, Hd, Hd, Dd, Dd, Hd, Hd, Dd, Hd, Dd, Dd, Dd, Dd, Rd, Rd, Rd, Rd, Rd, Rd, Rd, Dd, Dd, Dd, Dd, Dd, Dd, Dd, Dd, Hd, Hd, Hd, Dd, Dd, Dd, Dd
Md, Md, Md, Md, Md, Mm^Xm, Mm^Xm, Mm^Xm, Mm^Xm, Mm^Xm, Md, Md, Md, Md, Md, Hh, Gll^Fp, Gll^Fp, Gll^Fp, Gll^Fp, Gll^Fp, Gll^Fp, Wwg, Wwg, Wwg, Wwg, Wwg, Hhd, Md, Hhd, Hd, Hd, Hd, Hd, Hd, Hd, Hd, Dd, Hd, Hd, Dd, Dd, Dd, Dd, Rd, Rd, Rd, Rd, Rd, Dd, Dd, Hd, Hd, Hd, Hd, Hd, Hd, Dd, Dd, Dd, Dd, Dd, Dd, Hd, Dd
