border_size=1
usage=map

Mm          , Mm          , Mm          , Mm          , Mm          , Mm          , Mm          , Mm          , Mm          , Mm          , Mm          , Mm          , Rd          , Mm          , Mm          , Mm          , Mm          , Mm          , Mm          , Mm          , Ms          , Ms          , Ms          , Ms          , Ms          , Ms          , Ms          , Ms          , Ms          , Ms          , Aa          , Ms          , Ms          , Ms          , Ms          , Ms          , Ms          , Ms          , Ms          , Ms          , Ms          , Ms          , Ms          , Ms          
Mm          , Mm          , Mm          , Mm          , Mm          , Mm          , Mm          , Mm          , Mm          , Mm          , Mm          , Mm          , Rd          , Mm          , Mm          , Mm          , Hh^Vhh      , Mm          , Mm          , Mm          , Mm          , Ms          , Ms          , Ms          , Ha          , Ms          , Ms          , Ms          , Ms          , Ms          , Ms          , Aa          , Ms          , Ms          , Ms          , Ms          , Ms          , Ms          , Ms          , Ms          , Ms          , Ms          , Ms          , Ms          
Mm          , Mm          , Mm          , Mm          , Hh          , Hh          , Hh          , 4 Hh^Vhh    , Hh          , Hh          , Hh^Fp       , Hh^Fp       , Rd          , Hh^Fp       , Hh^Fp       , Hh          , Hh          , Hh          , Hh          , Mm          , Hh          , Ms          , Ha          , Ha          , Hh          , Ha          , Ha          , Ms          , Ha          , Ha          , Aa          , Aa          , Ha          , Ha          , Ha          , Ha          , Ha          , Ha          , Ms          , Ms          , Ms          , Ms          , Ms          , Ms          
Mm          , Mm          , Mm          , Hh^Vhh      , Hh          , Hh          , Gs^Fp       , Hh          , Gs^Fp       , Gs^Fp       , Hh^Fp       , Rd          , Re^Vct      , Gs^Fp       , Gs^Fp       , Gs^Fp       , Hh          , Hh          , Hh          , Mm          , Hh          , Hh          , Ha          , Hh          , Gs          , Hh          , Hh          , Ha          , Hh          , Rd          , Hh          , Hh          , Hh          , Hh          , Hh          , 2 Hh^Vc     , Hh          , Ha          , Ha          , Ms          , Ms          , Ms          , Aa          , Aa          
Rd          , Rd          , Rd          , Rd          , Rd          , Hh^Fp       , Gs^Fp       , Hh^Fp       , Rd          , Gs^Fp       , Rd          , Rd          , Rd          , Gs^Fp       , Rd          , Gs^Fp       , Ce          , Gg          , Gg          , Hh          , Gg          , Hh          , Hh          , Hh          , Gs          , Gs          , Gs          , Hh^Vc       , Rd          , Rd          , Gs          , Hh^Vc       , Gs          , Gs          , Hh          , Hh          , Hh          , Ha          , Ha          , Ms          , Ms          , Ms          , Aa          , Ms          
Mm          , Mm          , Hh          , Hh^Fp       , Gs^Fp       , Rd          , Rd          , Rd          , Re^Vct      , Rd          , Gs^Fp       , Hh^Fp       , Gs^Fp       , Rd          , Gs^Fp       , Rd          , Rd          , Rd          , Rd          , Gg          , Rd          , Hh          , Ce          , Gs          , Rd          , Rd          , Rd          , Rd          , Gs          , Gs          , Gs          , Gs          , Gs          , Hh          , Hh          , Hh          , Hh          , Hh          , Ha          , Ha          , Aa          , Aa          , Ha          , Ms          
Ww          , Ww          , Hh          , Gs^Fp       , Hh^Fp       , Gs^Fp       , Hh^Fp       , Gs^Fp       , Gs^Fp       , Gs^Fp       , Hh^Fp       , Gs^Fp       , Hh^Fp       , Rd          , Rd          , Ce          , Gg          , Gg          , Gg^Vh       , Rd          , Hh^Fds      , Rd          , Rd          , Ce          , Rp          , Gs          , Gs          , Gs          , Gs          , Gs          , Gs          , Gs          , Gs^Fdw      , Hh          , Hh          , Gs^Fdw      , Hh^Vc       , Hh          , Ha          , Ha          , Aa          , Ms          , Ha          , Ms          
Ww          , Ww          , Ww          , Ww          , Wwf         , Hh^Fp       , Hh^Fp       , Gs^Fp       , Hh^Fp       , Gs^Fp       , Gs^Fp       , Hh^Fp       , Hh^Fp       , Gs^Fp       , Ce          , Ce          , Gg          , Gg          , Gg          , Gg          , Re^Gvs      , Hh          , Hh          , Rp          , Gg^Vh       , Ce          , Gs          , Gs          , Gs^Fdw      , Ss^Vhs      , Gs^Fdw      , Ss          , Ss          , Gs^Fdw      , Gs^Fdw      , Gs^Fdw      , Hh          , Hh          , Hh          , Aa          , Ha          , Ha          , Ha          , Ha          
Mm          , Ww          , Ww          , Wwf         , Ww          , Ww          , Hh^Fp       , Gs^Fp       , Hh^Fp       , Gs^Fp       , Hh^Fp       , Gs^Fp       , Hh^Fp       , Ww          , Ww          , Ww^Bw\      , Ww          , Hh          , Mm          , Re^Gvs      , Re^Gvs      , Re^Gvs      , Gg^Wm       , Rp          , Gg          , Ce          , Hh          , Gs^Fdw      , Gs^Fdw      , Ss          , Gs^Fdw      , Ss          , Gs^Fdw      , Ss          , Gs^Fdw      , Gs^Fdw      , Gs^Fdw      , Hh          , Hh          , Re          , Hh          , Hh          , Hh          , Hh          
Mm          , Mm          , Mm          , Mm^Vhh      , Ww          , Ww          , Ww          , Ww          , Ww          , Hh^Fp       , Ww          , Ww          , Ww          , Ww          , Ww          , Ww^Bw|      , Ww          , Ww          , Mm          , Hh^Fds      , Gs^Fds      , Gg          , Gg          , Rp          , Rp          , Gg          , Hh          , Ss          , Ss          , Ss          , Ss          , Ss          , Gs^Fdw      , Gs^Fdw      , Gs^Fdw      , Gs^Fdw      , Ss          , Gs^Fdw      , Gs^Fdw      , Re          , Hh^Vc       , Hh          , Re          , Hh          
Mm          , Mm          , Mm          , Mm          , Wo          , Wo          , Wo          , Ww          , Ww          , Wwf         , Wwf         , Ww          , Wwf         , Ww          , Hh^Vhh      , Chr         , Ww^Bw\      , Ww          , Re^Gvs      , Re^Gvs      , Re^Gvs      , Gg          , Gg^Vh       , Gg          , Rp          , Hh          , Hh^Fdw      , Hh^Fdw      , Ss^Vhs      , Ss          , Ss          , Ss          , Ss          , Ss          , Ss          , Ss          , Ss          , Ss          , Re          , Re          , Re          , Re          , Hh^Fp       , Re          
Mm          , Mm          , Mm          , Mm          , Mm          , Mm          , Mm          , Mm          , Hh          , Hh          , Hh          , Hh          , Hh          , Hh          , Hh          , Wo          , Ww^Bw|      , Ww          , Re^Gvs      , Re^Gvs      , Gs^Fds      , Gg          , Rd          , Rd          , Rp          , Hh          , Hh          , Ss          , Ss          , Ss          , Ss          , Gs^Fdw      , Gs^Fdw      , Ss          , Ss^Vhs      , Ss          , Ss          , Gs^Fdw      , Gs^Fdw      , Gs^Fdw      , Hh^Fmw      , Ce          , Rd          , Hh^Fp       
Mm          , Mm          , Mm          , Mm          , Hh          , Mm          , Mm          , Mm          , Mm          , Mm          , Mm          , Hh          , Wo          , Mm          , Wo          , Wo          , Ww          , Ww^Bw\      , Rd          , Gs^Fds      , Rd          , Hh^Fds      , Rd          , Ce          , Rp^Vhc      , Ch          , Hh          , Hh^Fdw      , Ss          , Ss          , Ss          , Ss          , Gs^Fdw      , Ss          , Ss          , Gs^Fdw      , Gs^Fdw      , Gs^Fdw      , Gs^Fdw      , Gs^Fdw      , Hh^Fmw      , Hh^Fp       , Rd          , Hh^Fp       
Ww          , Mm          , Mm          , Hh          , Hh          , Mm          , Hh^Fds      , Hh          , Hh^Fds      , Mm          , Wo          , Hh          , Wo^Bw\      , Wo          , Wo          , Ww          , Ww          , Gs^Fds      , Gg^Vh       , Rd          , Gg          , Rd          , Ce          , Ce          , 1 Ch        , Ch          , Hh          , Gs^Fdw      , Gs^Fdw      , Gs^Fdw      , Gs^Fdw      , Gs^Fdw      , Gs^Fdw      , Ss          , Gs^Fdw      , Ss          , Gs^Fdw      , Gs^Fdw      , Gs^Fmw      , Hh^Fmw      , Hh^Fmw      , Hh^Fp       , Rd          , Hh^Fp       
Mm          , Ww          , Ww          , Wwf         , Ww          , Hh^Fds      , Ww          , Hh^Fds      , Hh^Fds      , Wo          , Wo          , Wo          , Wo^Bw|      , Wo          , Wo          , Gs^Fds      , Gs^Fds      , Gs^Fds      , Gs^Fds      , Gg          , Re^Gvs      , Re^Gvs      , Re^Gvs      , Ch          , Rp^Vhc      , Ch          , Ch          , Gs^Fdw      , Gs^Fmw      , Gs^Fdw      , Gs^Fmw      , Gs^Fmw      , Gs^Fmw      , Re          , Gs^Fdw      , Gs^Fdw      , Gs^Fmw      , Gs^Fdw      , Hh^Fmw      , Mm^Vhh      , Rd          , Rd          , Hh^Fp       , Hh^Fp       
Mm          , Mm          , Mm          , Mm^Vhh      , Mm          , Ww          , Hh^Fds      , Wwr         , Wwr         , Wo          , Wo          , Wo          , Hh^Fds      , Wo          , Hh^Fds      , Hh^Fds      , Gs^Fds      , Gs^Fds      , Gs^Fds      , Gg          , Re^Gvs      , Re^Gvs      , Rp          , Rp          , Rd          , Ch          , Gs^Fds      , Gs^Fp       , Gs^Fp       , Gs^Fmw      , Gs^Fmw      , Gs^Fmw      , Re          , Re          , Gs^Fmw      , Gs^Fmw      , Gs^Fp       , Gs^Fmw      , Hh^Fp       , Hh^Fp       , Rd          , Hh^Fp       , Hh^Fp       , Hh^Fp       
Mm          , Hh          , Mm          , Mm          , Mm          , Mm          , Hh^Fds      , Hh^Fds      , Wwr         , Wo          , Wwr         , Wo          , Wwr         , Hh^Fds      , Hh^Fds      , Gg^Ve       , Gs^Fds      , Gs^Fds      , Ce          , Re^Gvs      , Re^Gvs      , Re^Gvs      , Rp          , Gg          , Ce          , Rd          , Rd          , Gs^Fms      , Gs^Fms      , Gs^Fmw      , Hh^Fp       , Gs^Fp       , Re          , Gs^Fmw      , Gs^Fp       , Gs^Fp       , Gs^Fp       , Gs^Fp       , Hh^Fp       , Ce          , Hh^Fp       , Hh^Fp       , Hh^Fp       , Hh^Fp       
Dd          , Hh          , Dd          , Hh          , Hh          , Mm          , Mm          , Hh^Fds      , Mm          , Wwr         , Hh^Fds      , Wwr         , Wwf         , Wwf         , Mm          , Hh^Fds      , Hh^Fds      , Gs^Fds      , Rd          , Ce          , Rd          , Rd          , Rd          , Gg^Vh       , Ce          , Gs^Fms      , Gs^Fms      , Rd          , Rd          , Rd          , Rd          , Gs^Fms      , Re^Vct      , Gs^Fp       , Hh^Fp       , Gs^Fp       , Gs^Fp       , Hh^Fp       , Gs^Fp       , Ur          , Gs^Fp       , Hh^Fp       , Hh^Fp       , Hh^Fp       
Dd          , Dd          , Dd          , Hh          , Dd          , Hh          , Hh          , Mm          , Hh          , Mm          , Mm          , Mm          , Dd          , Wwf         , Wwf         , Mm          , Rd          , Rd          , Gs^Fds      , Rd          , Gs^Fds      , Gs^Fds      , Rd          , Ce          , Gs^Fds      , Gs^Fds      , Hh^Fds      , Gs^Fms      , Gs^Fms      , Gs^Fms      , Gs^Fms      , Rd          , Gs^Fp       , Gs^Fp       , Gs^Fp       , Gs^Fp       , Gs^Fp       , Gs^Fp       , Uu^Vu       , Ur          , Ur^Uf       , Hh^Fp       , Hh^Fp       , Hh^Fp       
Dd          , Dd^Do       , Dd          , Dd          , Dd          , Hh          , Hh          , Hh          , Dd          , Hh          , Dd          , Dd          , Rd          , Wwf         , Wwf         , Rd          , Hh^Fds      , Hh^Fds      , Gs^Fds      , Gs^Fds      , Gs^Fds      , Gs^Fds      , Rd          , Gs^Fds      , Gs^Fds      , Gg^Efm      , Gg^Efm      , Gs^Fds      , Gs^Fds      , Gs^Fms      , Gs^Fms      , Rd          , Gs^Fp       , Gs^Fp       , Gs^Fp       , Ur          , Ur          , Ur          , Ur          , Ur          , Ur^Uf       , Uh          , Uh          , Uh          
Dd          , Dd^Vda      , Dd          , Dd          , Dd          , Dd          , Hh          , Dd          , Hh          , Hh          , Rd          , Rd          , Dd          , Wwf         , Wwf         , Hh          , Hh^Fds      , Gs^Fds      , Gs^Fds      , Gg^Efm      , Hh^Fds      , Gs^Fds      , Gs^Fds      , Rd          , Gs^Fds      , Gg^Ve       , Gg^Efm      , Gs^Fds      , Gs^Fms      , Hh^Fms      , Gs^Fp       , Rd          , Rd          , Gs^Fp       , Gs^Fp       , Ur          , Ur          , Ur          , Ur          , Ur^Uf       , Uh          , Uh          , Uh          , Uh          
Dd          , Dd          , Dd          , Hd          , Dd          , Dd          , Dd          , Dd          , Dd          , Dd          , Rd          , Dd^Do       , Dd          , Ww          , Wwf         , Hh          , Hh^Fds      , Gs^Fds      , Gs^Fds      , Gs^Fds      , Gs^Fds      , Gs^Fds      , Gs^Fds      , Rd          , Gs^Fds      , Gs^Fds      , Cv          , Gs^Fds      , Gs^Fms      , Gs^Fms      , Gs^Fp       , Gs^Fp       , Gs^Fp       , Re^Vct      , Ur          , Ur          , Ur          , Ur          , Ur^Uf       , Uu^Vud      , Uh          , Uh          , Uh          , Uh          
Dd          , Dd          , Hd          , Hd          , Dd          , Dd^Do       , Dd          , Dd          , Dd          , Dd^Vda      , Dd          , Dd          , Dd          , Dd          , Ww          , Wwf         , Gs^Fds      , Gs^Fds      , Gg^Efm      , Gs^Fds      , Gs^Fds      , Gs^Fds      , Rd          , Rd          , Gs^Fds      , Gs^Fds      , Hh^Fms      , Gs^Fms      , Ur          , Gs^Fp       , Uu^Vu       , Ur          , Ur          , Ur          , Ur          , Ur          , Ur          , Ur          , Ur          , Uh          , Uh          , Mm^Xm       , Mm^Xm       , Mm^Xm       
Dd          , Md^Xm       , Dd          , Dd          , Dd          , Dd          , Dd          , Dd          , Dd          , Dd          , Hd          , Dd          , Dd          , Dd          , Ww          , Ww          , Cv          , Gg^Ve       , Gg^Efm      , Gs^Fds      , Gs^Fds      , Gg^Ve       , Rd          , Gs^Fds      , Gs^Fds      , Gs^Fds      , Hh^Fms      , Gs^Fms      , Gs^Fms      , Ur          , Ur          , Ur          , Ur          , Ur          , Uu^Uf       , Uh          , Uh          , Ur          , Cud         , Uh          , Xu          , Mm^Xm       , Mm^Xm       , Mm^Xm       
Hd          , Dd^Do       , 3 Dd^Vda    , Dd          , Dd          , Dd          , Dd          , Dd          , Dd          , Dd          , Dd          , Dd          , Dd          , Dd          , Dd          , Ww          , Ww          , Cv          , Gs^Fds      , Gs^Fds      , Gs^Fds      , Rd          , Hh^Fds      , Gs^Fds      , Gs^Fds      , Hh^Fms      , Hh^Fms      , Gs^Fms      , Gs^Fms      , Gs^Fp       , Ur          , Uh          , Uu^Uf       , Uh          , Uh          , Uh          , Xos         , Cud         , 5 Uu^Vud    , Xos         , Xu          , Xu          , Xu          , Xu          
Hd          , Dd          , Dd          , Md^Xm       , Dd          , Dd          , Dd^Vda      , Dd          , Dd          , Hd          , Dd          , Dd^Do       , Dd          , Dd          , Dd          , Ww          , Ww          , Gs^Fds      , Gs^Fds      , Gs^Fds      , Gs^Fds      , Rd          , Rd          , Gs^Fds      , Gs^Fds      , Gs^Fds      , Hh^Fms      , Gs^Fms      , Gs^Fms      , Ur          , Ur          , Uh          , Uh          , Uh          , Xu          , Xu          , Xu          , Xos         , Xos         , Xos         , Xu          , Xu          , Xu          , Xu          
Hd          , Hd          , Hd          , Dd          , Dd          , Dd          , Dd          , Dd          , Dd          , Hd          , Hd          , Hd          , Hd          , Hd          , Dd          , Dd          , Ww          , Ww          , Gg          , Gs^Fds      , Gs^Fds      , Gs^Fds      , Gs^Fds      , Rd          , Gs^Fds      , Gs^Fds      , Gs^Fds      , Gs^Fds      , Gs^Fms      , Gs^Fms      , Mm^Xm       , Mm^Xm       , Mm^Xm       , Xu          , Xu          , Xu          , Xu          , Xu          , Xu          , Xu          , Xu          , Xu          , Xu          , Xu          
