border_size=1
usage=map

Mm, Mm, Mm, Mm, Mm, Mm, Mm, Mm, Mm, Mm, Mm, Mm, Re, Mm, Mm, Mm, Mm, Mm, Mm, Mm, Ms, Ms, Ms, Ms, Ms, Ms, Ms, Ms, Ms, Ms, Aa, Ms, Ms, Ms, Ms, Ms, Ms, Ms, Ms, Ms, Ms, Ms, Ms, Ms
Mm, Mm, Mm, Mm, Mm, Mm, Mm, Mm, Mm, Mm, Mm, Mm, Re, Mm, Mm, Mm, Hh^Vhh, Mm, Mm, Mm, Mm, Ms, Ms, Ms, Ha, Ms, Ms, Ms, Ms, Ms, Ms, Aa, Ms, Ms, Ms, Ms, Ms, Ms, Ms, Ms, Ms, Ms, Ms, Ms
Mm, Mm, Mm, Mm, Hh, Hh, Hh, 4 Hh^Vhh, Hh, Hh, Hh^Fp, Hh^Fp, Re, Hh^Fp, Hh^Fp, Hh, Hh, Hh, Hh, Mm, Hh, Ms, Ha, Ha, Hh, Ha, Ha, Ms, Ha, Ha, Aa, Aa, Ha, Ha, Ha, Ha, Ha, Ha, Ms, Ms, Ms, Ms, Ms, Ms
Mm, Mm, Mm, Hh^Vhh, Hh, Hh, Gs^Fp, Hh, Gs^Fp, Gs^Fp, Hh^Fp, Re, Re^Vct, Gll^Fp, Gll^Fp, Gll^Fp, Hh, Hh, Hh, Mm, Hh, Hh, Ha, Hh, Gd, Hh, Hh, Ha, Hh, Rd, Hh, Hh, Hh, Hh, Hh, 2 Hh^Vc, Hh, Ha, Ha, Ms, Ms, Ms, Aa, Aa
Re, Re^Es, Re, Re, Re^Es, Hh^Fp, Gs^Fp, Hh^Fp, Re, Gs^Fp, Re, Re, Re, Gll^Fp, Re, Gll^Fp, Ket, Gg, Gg, Hh, Gs, Hh, Hh, Hh, Gd, Gs, Gs, Hh^Vc, Rd, Rd, Gs, Hh^Vc, Gs, Gs, Hh, Hh, Hh, Ha, Ha, Ms, Ms, Ms, Aa, Ms
Mm, Mm, Hh, Hh^Fp, Gs^Fp, Re, Re, Re, Re^Vct, Re, Gs^Fp, Hh^Fp, Gll^Fp, Re, Gll^Fp, Re, Re^Es, Re, Re, Gg, Re, Hh, Ce, Gs, Rd, Rd, Rd^Es, Rd, Gs, Gs, Gd, Gs, Gd, Hh, Hh, Hh, Hh, Hh, Ha, Ha, Aa, Aa, Ha, Ms
Ww, Ww, Hh, Gs^Fp, Hh^Fp, Gs^Fp, Hh^Fp, Gs^Fp, Gs^Fp, Gs^Fp, Hh^Fp, Gs^Fp, Gll^Fp, Re, Re, Ce, Gg, Gg, Gg^Vh, Re, Hh^Fds, Re, Re, Ce, Rp, Gs, Gs, Gs, Gs, Gs, Gs, Gs, Gs^Fdw, Hh, Hh, Gs^Fdw, Hhd^Vc, Hhd, Ha, Ha, Aa, Ms, Ha, Ms
Ww, Ww, Ww, Ww, Wwf, Hh^Fp, Hh^Fp, Gs^Fp, Hh^Fp, Gs^Fp, Gs^Fp, Hh^Fp, Hh^Fp, Gll^Fp, Ce, Ce, Gg, Gs, Gg, Gg, Re^Gvs, Hh, Hh, Rp, Gg^Vh, Ce, Gs, Gd, Gs^Fdw, Ss^Vhs, Gd^Fdw, Ss, Ss, Gs^Fdw, Gs^Fdw, Gs^Fdw, Hhd, Hhd, Hhd, Aa, Ha, Ha, Ha, Ha
Mm, Ww, Ww, Wwf, Ww, Ww, Hh^Fp, Gs^Fp, Hh^Fp, Gs^Fp, Hh^Fp, Gs^Fp, Hh^Fp, Ww, Ww, Ww^Bw\, Ww, Hh, Mm, Re^Gvs, Re^Gvs, Re^Gvs, Gg^Wm, Rp, Gg, Ce, Hh, Gs^Fdw, Gd^Fdw, Ss, Gd^Fdw, Ss, Gd^Fdw, Ss, Gd^Fdw, Gd^Fdw, Gs^Fdw, Hhd, Hhd, Re, Hh, Hh, Hh, Hh
Mm, Mm, Mm, Mm^Vhh, Ww, Ww, Ww, Ww, Ww, Hh^Fp, Ww, Ww, Ww, Ww, Ww, Ww^Bw|, Ww, Ww, Mm, Hh^Fds, Gs^Fds, Gg, Gg, Rp, Rp^Es, Gg, Hh, Ss, Ss, Ss, Ss, Ss, Gd^Fdw, Gd^Fdw, Gd^Fdw, Gs^Fdw, Ss, Gd^Fdw, Gs^Fdw, Re, Hh^Vc, Hh, Re, Hh
Mm, Mm, Mm, Mm, Wo, Wo, Wo, Ww, Ww, Wwf, Wwf, Ww, Wwf, Ww, Hh^Vhh, Chr, Ww^Bw\, Ww, Re^Gvs, Re^Gvs, Re^Gvs, Gg, Gg^Vh, Gg, Rp, Hh, Hhd^Fdw, Hhd^Fdw, Ss^Vhs, Ss, Ss, Ss, Ss, Ss, Ss, Ss, Ss, Ss, Re, Re, Re, Re, Hh^Fp, Re
Mm, Mm, Mm, Mm, Mm, Mm, Mm, Mm, Hh, Hh, Hh, Hh, Hh, Hh, Hh, Wo, Ww^Bw|, Ww, Re^Gvs, Re^Gvs, Gs^Fds, Gg, Rp, Rp, Rp, Hh, Hh, Ss, Ss, Ss, Ss, Gd^Fdw, Gd^Fdw, Ss, Ss^Vhs, Ss, Ss, Gs^Fdw, Gd^Fdw, Gs^Fdw, Hh^Fmw, Ce, Re, Hh^Fp
Mm, Mm, Mm, Mm, Hh, Mm, Mm, Mm, Mm, Mm, Mm, Hh, Wo, Mm, Wo, Wo, Ww, Ww^Bw\, Rp, Gs^Fds, Rp, Hh^Fds, Rp, Ce, Rp^Vhc, Ch, Hh, Hh^Fdw, Ss, Ss, Ss, Ss, Gd^Fdw, Ss, Ss, Gd^Fdw, Gd^Fdw, Gd^Fdw, Gs^Fdw, Gs^Fdw, Hh^Fmw, Hh^Fp, Re, Hh^Fp
Ww, Mm, Mm, Hh, Hh, Mm, Hh^Fds, Hh, Hh^Fds, Mm, Wo, Hh, Wo^Bw\, Wo, Wo, Ww, Ww, Gs^Fds, Gg^Vh, Rp, Gg, Rp, Ce, Ce, 1 Ch, Ch, Hh, Gs^Fdw, Gs^Fdw, Gs^Fdw, Gd^Fdw, Gd^Fdw, Gs^Fdw, Ss, Gs^Fdw, Ss, Gs^Fdw, Gd^Fdw, Gs^Fmw, Hh^Fmw, Hh^Fmw, Hh^Fp, Re, Hh^Fp
Mm, Ww, Ww, Wwf, Ww, Hh^Fds, Ww, Hh^Fds, Hh^Fds, Wo, Wo, Wo, Wo^Bw|, Wo, Wo, Gs^Fds, Gs^Fds, Gs^Fds, Gs^Fds, Gg, Re^Gvs, Re^Gvs, Re^Gvs, Ch, Rp^Vhc, Ch, Ch, Gs^Fdw, Gs^Fmw, Gd^Fdw, Gs^Fmw, Gs^Fmw, Gs^Fmw, Re, Gs^Fdw, Gs^Fdw, Gll^Fmw, Gs^Fdw, Hh^Fmw, Mm^Vhh, Re, Re, Hh^Fp, Hh^Fp
Md, Mm, Mm, Mm^Vhh, Mm, Ww, Hh^Fds, Wwr, Wwr, Wo, Wo, Wo, Hh^Fds, Wo, Hh^Fds, Hh^Fds, Gs^Fds, Gs^Fds, Gs^Fds, Gg, Re^Gvs, Re^Gvs, Rp, Rp, Rp, Ch, Gs^Fds, Gs^Fp, Gs^Fp, Gs^Fmw, Gs^Fmw, Gs^Fmw, Re, Re, Gs^Fmw, Gs^Fmw, Gs^Fp, Gs^Fmw, Hh^Fp, Hh^Fp, Re, Hh^Fp, Hh^Fp, Hh^Fp
Md, Hhd, Md, Mm, Mm, Mm, Hh^Fds, Hh^Fds, Wwr, Wo, Wwr, Wo, Wwr, Hh^Fds, Hh^Fds, Gg^Ve, Gs^Fds, Gs^Fds, Ce, Re^Gvs, Re^Gvs, Re^Gvs, Rp, Gg, Ce, Rp, Re, Gs^Fms, Gs^Fms, Gs^Fmw, Hh^Fp, Gs^Fp, Re, Gs^Fmw, Gll^Fp, Gll^Fp, Gll^Fp, Gll^Fp, Hh^Fp, Ce, Hh^Fp, Hh^Fp, Hh^Fp, Hh^Fp
Dd, Hhd, Dd, Hhd, Hhd, Mm, Mm, Hh^Fds, Mm, Wwr, Hh^Fds, Wwr, Wwf, Wwf, Mm, Hh^Fds, Hh^Fds, Gs^Fds, Rd, Ce, Rp, Rp, Rp, Gg^Vh, Ce, Gs^Fms, Gs^Fms, Re, Re, Re^Es, Re, Gs^Fms, Re^Vct, Gll^Fp, Hh^Fp, Gll^Fp, Gll^Fp, Hh^Fp, Gll^Fp, Rb, Gs^Fp, Hh^Fp, Hh^Fp, Hh^Fp
Dd, Dd, Dd, Hhd, Dd, Hhd, Hhd, Mm, Hhd, Mm, Md, Md, Dd, Wwf, Wwf, Mm, Rd, Rd^Es, Gs^Fds, Rd, Gs^Fds, Gs^Fds, Re, Ce, Gs^Fds, Gs^Fds, Hh^Fds, Gs^Fms, Gs^Fms, Gs^Fms, Gs^Fms, Re, Gll^Fp, Gll^Fp, Gll^Fp, Gll^Fp, Gll^Fp, Gll^Fp, Uu^Vu, Rb, Ur^Uf, Hh^Fp, Hh^Fp, Hh^Fp
Dd, Dd^Do, Dd, Dd, Dd, Hhd, Hhd, Hhd, Dd, Hhd, Dd, Dd, Rd^Es, Wwf, Wwf, Rd, Hh^Fds, Hh^Fds, Gs^Fds, Gs^Fds, Gs^Fds, Gs^Fds, Re, Gs^Fds, Gs^Fds, Gg^Efm, Gg^Efm, Gs^Fds, Gs^Fds, Gs^Fms, Gll^Fms, Re, Gll^Fp, Gll^Fp, Gll^Fp, Ur, Ur, Ur, Ur, Ur, Ur^Uf, Uh, Uh, Uh
Dd, Dd^Vda, Dd, Dd, Dd, Dd, Hhd, Dd, Hhd, Hhd, Rd, Rd, Dd, Wwf, Wwf, Hh, Hh^Fds, Gs^Fds, Gs^Fds, Gg^Efm, Hh^Fds, Gs^Fds, Gs^Fds, Re^Es, Gs^Fds, Gg^Ve, Gg^Efm, Gs^Fds, Gs^Fms, Hh^Fms, Gll^Fp, Re, Re, Gll^Fp, Gll^Fp, Ur, Ur, Ur, Ur^Em, Ur^Uf, Uh, Uu^Em, Uh, Uh
Dd, Dd, Dd, Hd, Dd, Dd, Dd, Dd, Dd, Dd, Rd, Dd^Do, Dd, Ww, Wwf, Hh, Hh^Fds, Gs^Fds, Gs^Fds, Gs^Fds, Gs^Fds, Gs^Fds, Gs^Fds, Re, Gs^Fds, Gs^Fds, Cv, Gs^Fds, Gll^Fms, Gs^Fms, Gll^Fp, Gll^Fp, Gll^Fp, Re^Vct, Rb, Ur, Ur^Em, Ur, Ur^Uf, Uu^Vud, Uu, Uu, Uh, Uh
Dd, Dd, Hd, Hd, Dd, Dd^Do, Dd, Dd, Dd, Dd^Vda, Dd, Dd, Dd, Dd, Ww, Wwf, Gs^Fds, Gs^Fds, Gg^Efm, Gs^Fds, Gs^Fds, Gs^Fds, Re, Re, Gs^Fds, Gs^Fds, Hh^Fms, Gs^Fms, Rb, Gll^Fp, Uu^Vu, Ur, Ur^Em, Ur, Ur, Ur, Ur, Ur, Ur, Uh, Uh, Mm^Xm, Mm^Xm, Mm^Xm
Dd, Md^Xm, Dd, Dd, Dd, Dd, Rd, Rd, Dd, Dd, Hd, Dd, Dd, Dd, Ww, Ww, Cv, Gg^Ve, Gg^Efm, Gs^Fds, Gs^Fds, Gg^Ve, Re, Gs^Fds, Gs^Fds, Gs^Fds, Hh^Fms, Gs^Fms, Gll^Fms, Rb, Ur, Ur, Ur, Ur, Uu^Uf, Uh, Uh, Ur^Em, Cud, Uu, Xu, Mm^Xm, Mm^Xm, Mm^Xm
Hd, Dd^Do, 3 Dd^Vda, Dd, Rd, Dd, Dd, Dd, Dd, Dd, Dd, Dd, Dd, Dd, Dd, Ww, Ww, Cv, Gs^Fds, Gs^Fds, Gs^Fds, Re, Hh^Fds, Gs^Fds, Gs^Fds, Hh^Fms, Hh^Fms, Gll^Fms, Gs^Fms, Gs^Fp, Ur^Em, Uh, Uu^Uf, Uh^Em, Uh, Uh, Xos, Cud, 5 Uu^Vud, Xos, Xu, Xu, Xu, Xu
Hd, Dd, Dd, Md^Xm, Rd, Dd, Dd^Vda, Dd, Dd, Hd, Dd, Dd^Do, Dd, Dd, Dd, Ww, Ww, Gs^Fds, Gs^Fds, Gs^Fds, Gs^Fds, Re, Re, Gs^Fds, Gs^Fds, Gs^Fds, Hh^Fms, Gs^Fms, Gs^Fms, Ur, Ur, Uh, Uh, Uu^Em, Xu, Xu, Xu, Xos, Xos, Xos, Xu, Xu, Xu, Xu
Hd, Hd, Hd, Dd, Dd, Dd, Dd, Dd, Dd, Hd, Hd, Hd, Hd, Hd, Dd, Dd, Ww, Ww, Gg, Gs^Fds, Gs^Fds, Gs^Fds, Gs^Fds, Re, Gs^Fds, Gs^Fds, Gs^Fds, Gs^Fds, Gs^Fms, Gs^Fms, Mm^Xm, Mm^Xm, Mm^Xm, Xu, Xu, Xu, Xu, Xu, Xu, Xu, Xu, Xu, Xu, Xu
