border_size=1
usage=map

_off^_usr, _off^_usr, _off^_usr, _off^_usr, _off^_usr, _off^_usr, _off^_usr, _off^_usr, _off^_usr, _off^_usr, _off^_usr, _off^_usr, _off^_usr, _off^_usr, _off^_usr, _off^_usr, _off^_usr, _off^_usr, _off^_usr, _off^_usr, _off^_usr, _off^_usr, _off^_usr, _off^_usr, _off^_usr, _off^_usr, _off^_usr, _off^_usr, _off^_usr, _off^_usr, _off^_usr, _off^_usr, _off^_usr, _off^_usr, _off^_usr, _off^_usr, _off^_usr, _off^_usr, _off^_usr, _off^_usr, _off^_usr
_off^_usr, _off^_usr, _off^_usr, _off^_usr, _off^_usr, _off^_usr, _off^_usr, _off^_usr, _off^_usr, _off^_usr, _off^_usr, _off^_usr, _off^_usr, _off^_usr, _off^_usr, _off^_usr, _off^_usr, _off^_usr, _off^_usr, _off^_usr, Xos, _off^_usr, _off^_usr, _off^_usr, _off^_usr, _off^_usr, _off^_usr, _off^_usr, _off^_usr, _off^_usr, _off^_usr, _off^_usr, _off^_usr, _off^_usr, _off^_usr, _off^_usr, _off^_usr, _off^_usr, _off^_usr, _off^_usr, _off^_usr
_off^_usr, _off^_usr, _off^_usr, _off^_usr, _off^_usr, _off^_usr, _off^_usr, _off^_usr, _off^_usr, _off^_usr, _off^_usr, _off^_usr, _off^_usr, _off^_usr, _off^_usr, _off^_usr, _off^_usr, _off^_usr, Xos, Xos, Ww, Xos, Xos, _off^_usr, _off^_usr, _off^_usr, _off^_usr, _off^_usr, _off^_usr, _off^_usr, _off^_usr, _off^_usr, _off^_usr, _off^_usr, _off^_usr, _off^_usr, _off^_usr, _off^_usr, _off^_usr, _off^_usr, _off^_usr
_off^_usr, _off^_usr, _off^_usr, _off^_usr, _off^_usr, _off^_usr, _off^_usr, _off^_usr, _off^_usr, _off^_usr, _off^_usr, _off^_usr, _off^_usr, _off^_usr, _off^_usr, _off^_usr, Xos, Xos, Ww, Ww, Ww^Vm, Ww, Ww, Xos, Xos, _off^_usr, _off^_usr, _off^_usr, _off^_usr, _off^_usr, _off^_usr, _off^_usr, _off^_usr, _off^_usr, _off^_usr, _off^_usr, _off^_usr, _off^_usr, _off^_usr, _off^_usr, _off^_usr
_off^_usr, _off^_usr, _off^_usr, _off^_usr, _off^_usr, _off^_usr, _off^_usr, _off^_usr, _off^_usr, _off^_usr, _off^_usr, _off^_usr, _off^_usr, _off^_usr, Xos, Xos, Ss, Ss, Gg, Gs, Gg, Gg, Gs, Ss, Ss, Xos, Xos, _off^_usr, _off^_usr, _off^_usr, _off^_usr, _off^_usr, _off^_usr, _off^_usr, _off^_usr, _off^_usr, _off^_usr, _off^_usr, _off^_usr, _off^_usr, _off^_usr
_off^_usr, _off^_usr, _off^_usr, _off^_usr, _off^_usr, _off^_usr, _off^_usr, _off^_usr, _off^_usr, _off^_usr, _off^_usr, _off^_usr, Xol, Xol, Iwr, Xos, Xos, Ss, Gs^Fp, Hh, Mm, Hh, Gs^Fp, Ss, Xos, Xos, Urb^Vud, Xol, Xol, _off^_usr, _off^_usr, _off^_usr, _off^_usr, _off^_usr, _off^_usr, _off^_usr, _off^_usr, _off^_usr, _off^_usr, _off^_usr, _off^_usr
_off^_usr, _off^_usr, _off^_usr, _off^_usr, _off^_usr, _off^_usr, _off^_usr, _off^_usr, _off^_usr, _off^_usr, Xol, Xol, 1 Ke, Iwr, Gll^Fp, Hhd, Iwr, Wwg, Wwg, Gg, Gg, Gs, Wwt, Wwt, Gs, Hhd, Gs^Ft, Urb, Cud, Xol, Xol, _off^_usr, _off^_usr, _off^_usr, _off^_usr, _off^_usr, _off^_usr, _off^_usr, _off^_usr, _off^_usr, _off^_usr
_off^_usr, _off^_usr, _off^_usr, _off^_usr, _off^_usr, _off^_usr, _off^_usr, _off^_usr, Xos, Xol, Iwr, Ce, Ce, Ce, Iwr, Iwr, Iwr, Iwr, Gll^Fp, Xos, Xos, Xos, Gd^Ft, Gd, Gs, Gd, Rd, Cud, Cud, 2 Kud, Urb, Xol, Xol, _off^_usr, _off^_usr, _off^_usr, _off^_usr, _off^_usr, _off^_usr, _off^_usr, _off^_usr
_off^_usr, _off^_usr, _off^_usr, _off^_usr, _off^_usr, _off^_usr, Xos, Xos, Xos, Iwr^Vct, Hhd, Gll^Fp, Iwr, Iwr, Iwr, Iwr, Iwr, Hhd^Vct, Xol, Xos, Hhd, Xos, Xos, Hhd, Rd, Rd^Es, Rd, Rd, Gs, Gs^Ft, Hhd, Urb, Xos, Xos, Xos, _off^_usr, _off^_usr, _off^_usr, _off^_usr, _off^_usr, _off^_usr
_off^_usr, _off^_usr, _off^_usr, _off^_usr, Xos, Xos, Ss, Ss, Ss, Xos, Wwg, Iwr, Iwr, Iwr, Hhd, Iwr, Wwf, Wwf, Gll, Hhd, Rb^Fdw, Hhd^Fdw, Rb, Wwf, Wwf, Rd, Hhd^Vud, Gd, Gs, Gd, Wwt, Xos, Ss, Ss, Ss, Xos, Xos, _off^_usr, _off^_usr, _off^_usr, _off^_usr
_off^_usr, _off^_usr, Xos, Xos, Ww, Ww, Gs, Hh, Gs, Gd^Ft, Gg^Es, Wwg, Xos, Gll^Fp, Xos, Xos, Gll^Fdw, Gll, Rb, Gll, Sm^Uf, Rb^Em, Rb, Rb, Hhd, Xos, Xos, Gs^Ft, Xos, Wwt, Gd^Es, Gs^Ft, Gs, Hh, Gs, Ww, Ww, Xos, Xos, _off^_usr, _off^_usr
_off^_usr, Xos, Xos, Ww, Ww, Ww^Vm, Gd, Mm, Gs, Gs, Gd, Hh, Xos, Xos, Xol, Hhd, Hhd, Hhd^Fdw, Rb, Sm^Vhs, Sm^Uf, Sm^Vhs, Rb, Hhd^Fdw, Gll^Fdw, Hhd, Xol, Xos, Xos, Hh, Gs, Gs, Gd, Mm, Gs, Ww^Vm, Ww, Ww, Xos, Xos, _off^_usr
_off^_usr, _off^_usr, _off^_usr, Xos, Xos, Ww, Ss, Hh, Ss, Gs^Ft, Wwt, Wwt, Gg^Efm, Gs^Ft, Hh^Vhh, Xol, Wwf, Rb, Rb, Rb^Em, Rb^Fdw, Gll, Gll, Gll, Wwf, Xol, Hh, Gs^Fp, Rp, Ww, Ww, Gs^Ft, Ss, Hh, Ss, Ww, Xos, Xos, _off^_usr, _off^_usr, _off^_usr
_off^_usr, _off^_usr, _off^_usr, _off^_usr, _off^_usr, Xos, Xos, Ss, Xos, Xos, Hh, Gs^Efm, Gs^Efm, Gs^Efm, Rb, Rb, Rb, Wwf, Xol, Hhd^Fdw, Hhd, Hhd, Xos, Wwf, Rp, Rp, Rp, Rr, Rp^Es, Rr, Hh, Xos, Xos, Ss, Xos, Xos, _off^_usr, _off^_usr, _off^_usr, _off^_usr, _off^_usr
_off^_usr, _off^_usr, _off^_usr, _off^_usr, _off^_usr, _off^_usr, _off^_usr, Xos, Xos, Gs^Efm, Gg^Efm, Gs^Ft, Cv, Rb, Rb, Rb, Gs^Efm, Hh, Gs^Ft, Xol, Xos, Xos, Gs^Fp, Hh^Vhh, Rr^Es, Rp, Rp, Rp, Chr, Gg^Fp, Rr, Gg^Vd, Xos, Xos, _off^_usr, _off^_usr, _off^_usr, _off^_usr, _off^_usr, _off^_usr, _off^_usr
_off^_usr, _off^_usr, _off^_usr, _off^_usr, _off^_usr, _off^_usr, _off^_usr, _off^_usr, _off^_usr, Xos, Xos, 4 Kv, Cv, Cv, Gs^Ft, Gg^Efm, Gs^Efm, Gg^Efm, Wwt, Xos, Gd, Xos, Wwt, Rr, Rp, Rr, Gg^Fp, Chr, 3 Khr, Chr, Xos, Xos, _off^_usr, _off^_usr, _off^_usr, _off^_usr, _off^_usr, _off^_usr, _off^_usr, _off^_usr, _off^_usr
_off^_usr, _off^_usr, _off^_usr, _off^_usr, _off^_usr, _off^_usr, _off^_usr, _off^_usr, _off^_usr, _off^_usr, _off^_usr, Xos, Xos, Gs^Efm, Gg^Ve, Hh, Xos, Wwt, Gd^Fts, Gd, Md, Gd^Es, Gd^Fts, Wwt, Xos, Hh, Gg, Gg, Xos, Xos, _off^_usr, _off^_usr, _off^_usr, _off^_usr, _off^_usr, _off^_usr, _off^_usr, _off^_usr, _off^_usr, _off^_usr, _off^_usr
_off^_usr, _off^_usr, _off^_usr, _off^_usr, _off^_usr, _off^_usr, _off^_usr, _off^_usr, _off^_usr, _off^_usr, _off^_usr, _off^_usr, _off^_usr, Xos, Xos, Xos, Ss, Ss, Gd, Hhd, Gd, Hhd, Gs, Ss, Ss, Xos, Xos, Xos, _off^_usr, _off^_usr, _off^_usr, _off^_usr, _off^_usr, _off^_usr, _off^_usr, _off^_usr, _off^_usr, _off^_usr, _off^_usr, _off^_usr, _off^_usr
_off^_usr, _off^_usr, _off^_usr, _off^_usr, _off^_usr, _off^_usr, _off^_usr, _off^_usr, _off^_usr, _off^_usr, _off^_usr, _off^_usr, _off^_usr, _off^_usr, _off^_usr, Xos, Xos, Ss, Wwt, Gd, Wwt^Vm, Gd, Wwt, Ss, Xos, Xos, _off^_usr, _off^_usr, _off^_usr, _off^_usr, _off^_usr, _off^_usr, _off^_usr, _off^_usr, _off^_usr, _off^_usr, _off^_usr, _off^_usr, _off^_usr, _off^_usr, _off^_usr
_off^_usr, _off^_usr, _off^_usr, _off^_usr, _off^_usr, _off^_usr, _off^_usr, _off^_usr, _off^_usr, _off^_usr, _off^_usr, _off^_usr, _off^_usr, _off^_usr, _off^_usr, _off^_usr, _off^_usr, Xos, Xos, Wwt, Wwt, Wwt, Xos, Xos, _off^_usr, _off^_usr, _off^_usr, _off^_usr, _off^_usr, _off^_usr, _off^_usr, _off^_usr, _off^_usr, _off^_usr, _off^_usr, _off^_usr, _off^_usr, _off^_usr, _off^_usr, _off^_usr, _off^_usr
_off^_usr, _off^_usr, _off^_usr, _off^_usr, _off^_usr, _off^_usr, _off^_usr, _off^_usr, _off^_usr, _off^_usr, _off^_usr, _off^_usr, _off^_usr, _off^_usr, _off^_usr, _off^_usr, _off^_usr, _off^_usr, _off^_usr, Xos, Xos, Xos, _off^_usr, _off^_usr, _off^_usr, _off^_usr, _off^_usr, _off^_usr, _off^_usr, _off^_usr, _off^_usr, _off^_usr, _off^_usr, _off^_usr, _off^_usr, _off^_usr, _off^_usr, _off^_usr, _off^_usr, _off^_usr, _off^_usr
_off^_usr, _off^_usr, _off^_usr, _off^_usr, _off^_usr, _off^_usr, _off^_usr, _off^_usr, _off^_usr, _off^_usr, _off^_usr, _off^_usr, _off^_usr, _off^_usr, _off^_usr, _off^_usr, _off^_usr, _off^_usr, _off^_usr, _off^_usr, _off^_usr, _off^_usr, _off^_usr, _off^_usr, _off^_usr, _off^_usr, _off^_usr, _off^_usr, _off^_usr, _off^_usr, _off^_usr, _off^_usr, _off^_usr, _off^_usr, _off^_usr, _off^_usr, _off^_usr, _off^_usr, _off^_usr, _off^_usr, _off^_usr
_off^_usr, _off^_usr, _off^_usr, _off^_usr, _off^_usr, _off^_usr, _off^_usr, _off^_usr, _off^_usr, _off^_usr, _off^_usr, _off^_usr, _off^_usr, _off^_usr, _off^_usr, _off^_usr, _off^_usr, _off^_usr, _off^_usr, _off^_usr, _off^_usr, _off^_usr, _off^_usr, _off^_usr, _off^_usr, _off^_usr, _off^_usr, _off^_usr, _off^_usr, _off^_usr, _off^_usr, _off^_usr, _off^_usr, _off^_usr, _off^_usr, _off^_usr, _off^_usr, _off^_usr, _off^_usr, _off^_usr, _off^_usr
