border_size=1
usage=map

Gs^Fds, Gs^Fds, Gs^Fds, Gs^Fds, Gs^Fds, Gg, Gg, Gs^Fds, Hh^Fds, Hh^Fds, Hh, Gs^Fds, Gs^Fds, Rb, Wwf, Gs^Fds, Gs^Fds, Gs^Fds, Rb, Gs^Fds, Gs^Fds, Gs^Fds, Gs^Fds, Gs^Fds, Rb, Rd, Gs^Fds, Gs^Fds, Gs^Fds, Gs^Fds, Gs^Fds, Gs^Fds, Gs^Fds, Gs^Fds, Re, Gs^Fds, Gs^Fds, Rd, Wwf, Wwf, Gs^Fds, Gs^Fds, Gs^Fds, Gs^Fds, Gs^Fds
Gs^Fds, Gs^Fds, Gg, Hh, Hh^Fds, Gs^Fds, Gg, Gs^Fds, Hh, Hh, Gg, Gg, Gg, Rb, Rb, Wwf, Wwf, Gs^Fds, Wwf, Gs^Fds, Gs^Fds, Gs^Fds, Gs^Fds, Gs^Fds, Wwf, Gs^Fds, Gs^Vct, Gs^Fds, Gg, Gs^Fds, Gg, Gs^Fds, Re, Re, Hh^Fds, Gs^Fds, Wwf, Wwf, Re, Gs^Fds, Gg, Gs^Fds, Gs^Fds, Gs^Fds, Gs^Fds
Ww, Gs^Fds, Gs^Fds, Hh, Hh, Gg, Gs^Fds, Gg, Hh, Gg, Gs^Fds, Gs^Fds, Gs^Fds, Gg^Vh, Re, Rb^Es, Rb, Wwf, Rb, Wwf, Wwf, Wwf, Wwf, Wwf, 3 Ke, Wwf, Wwf, Gg, Wwf, Gg^Efm, Re, Re^Es, Gg, Hh, Wwf, Wwf, Hh, Gg, Re^Es, Hh^Fds, Gg, Gg^Efm, Wwf, Gs^Fds, Wwf
Ww, Ww, Ww, Ww, Ww, Gs^Fds, Gs^Fds, Gg, Gs^Fds, Gg, Gg^Efm, Gs^Fds, Gg, Re, Gs^Fds, Hh^Fms, Hh^Fms, Rb, Rb, Rb, Rb, Gg^Vh, Ce, Ce, Ce, Ce, Ce, Wwf, Hh^Fds, Wwf, Wwf, Wwf, Wwf, Wwf, Hh, Wwf, Wwf, Gg, Wwf, Wwf, Wwf, Wwf, Gg, Wwf, Gs^Fds
Ww, Ww, Ww, Ww, Ww, Ww, Ww, Ww, Ww, Hh, Hh^Fds, Gs^Fds, Ce, 4 Ke, Ce, Hh, Hh, Gg, Gg^Wm, Rb, Rb, Rb, Rb^Ecf, Gs^Fds, Gs^Fds, Wwf, Gs^Fds, Gs^Fds, Re, Re^Edt, Gg^Eff, Gs^Fds, Gs^Fds, Gg^Es, Gg, Hh, Gg, Wwf, 5 Ke, Re^Vct, Ce, Gg, Gg^Efm, Gs^Fds, Gs^Fds
Mm, Mm, Mm, Ww, Ww, Ww, Wo, Wo, Ww^Ewl, Ww, Gs^Fds, Gg, Ce, Ce, Ce, Gg, Rb^Gvs, Gg^Vh, Rb^Gvs, Gg, Hh, Rb^Es, Rb, Hh^Fds, Rb, Wwf, Wwf, Re, Gg^Vh, Gg^Eff, Rb^Gvs, Rb^Gvs, Rb^Gvs, Gg^Eff, Gg^Eff, Gg, Gg^Edt, Ce, Gg, Ce, Ss^Vhs, Gg, Wwr, Wo, Wo
Hh, Mm, Hh, Mm, Mm, Mm, Ww, Wo, Ww, Ww, Wo, Re, Wwf, Wwf, Rb^Gvs, Rb^Gvs, Rb^Gvs, Rb^Gvs, Rb^Gvs, Rb^Gvs, Rb^Gvs, Hh, Rb, Rb^Es, Rb, Rb, Wwf, Gg, Gg, Rb^Gvs, Rb^Gvs, Rb^Gvs, Rb^Gvs, Rb^Gvs, Rb^Gvs, Gg, Ce, Ce, Gg, Gg, Ww, Ww, Ww, Ww, Wo
Rd, Rd, Rd, Hh, Hh, Mm, Mm, Mm, Hh^Fp, Ww, Wo, Wo, Wwf, Ce, Ww, Rb^Gvs, Ww^Vm, Rb^Gvs, Hh, Rb^Gvs, Hh^Fp, Gg, Ww^Bw|, Ww^Bw|, Ww^Bw|, Gg, Hh^Fp, Wwf, Gg, Gg, Gg^Wm, Rb^Gvs, Rb^Gvs, Rb^Gvs, Gs^Fds, Gg, Gg^Vh, Gg, Hh, Gg, Ww^Bw\r, Wo, Wo, Wo, Gs^Fds
Mm^Xm, Hh, Mm, Rd, Rd, Rd, Rd, Hh^Fp, Hh^Fp, Wo, Gs^Fp, Ww, Wwf, Ww, Wo, Ww, Ww, Wwf, Wwf, Wwf, Ww, Ww, Ww^Bw|, Ww^Bw|, Ww^Bw|, Ww, Ww, Ww, Ww, Wwf, Ww^Ewl, Gg, Wwf, Gs^Fds, Wwr, Gs^Fds, Wwr, Gg, Wwf, Ww, Wo, Wo, Ww, Ww, Gs^Fms
Mm^Xm, Mm^Xm, Mm^Xm, Mm, Hh^Fp, Rd^Es, Rd, Rd, Rd^Es, Wwf, Rd, Wwf, Wwf, Ww, Wo, Wo, Ww, Ww, Wo, Ww, Wo, Wo, Ww^Bw|, Ww^Bw|, Ww^Bw|, Wo, Wo, Wo, Ww^Vm, Ww, Wo, Ww, Wwf, Wwf, Ww, Ww, Ww, Ww, Wwf, Ww, Ww^Ewl, Wo, Gs^Fms, Gs^Fms, Gs^Fms
Mm^Xm, Mm^Xm, Mm^Xm, Mm, Wwf, Hh^Fp, Wwf, Wwf, Wwf, Wwf, Rd, Rd, Rd, Gs^Vl, Gd^Fp, Wo, Gs^Efm, Wwf, Chs, Ss, Ss, Ww, Ww^Bw|, Ww^Bw|, Ww^Bw|, Ww, Ss, Ww, Wwf, Ww, Wo, Wo, Ww, Ww, Ww, Ww, Ww, Wwf, Ww, Ww, Ww^Vm, Ww, Gs^Em, Gll^Fms, Gs^Fms
Mm^Xm, Mm^Xm, Mm^Xm, Mm, Hh^Fp, Wwf, Gs^Fp, Gg^Vh, Rd, Rd, Hhd, Rd^Es, Rd, Rd, Rd, Gd^Fp, Rr^Vht, Gs^Fp, Gs^Fp, Ss, Ss^Vhs, Wwf^Edb, Chw, Khw, Chw, Wwf^Edb, Ss^Vhs, Ss, Chs, Wo, Wo, Wwf, Wwf, Ww, Gs^Fp, Ww, Wwf, Re, Gll^Fp, Gll^Fp, Gll^Fp, Wwf, Gs^Fp, Gs^Fms, Gll^Fms
Xu, Xu, Xu, Xu, Xu, Xu, Xu, Gg^Efm, Rd, Hhd^Fp, Gll^Fp, Rd, Gll^Fp, Rd^Es, Rd, Rd, Gd^Fp, Rr, Rr, Gs, Chr, Chw, Urb^Vud, Chw, Urb^Vud, Chw, Chr, Gs^Fp, Hh^Fp, Gs, Gs^Fp, Gs^Fp, Gs, Gs^Vhhr, Gs^Fp, Gs^Fp, Re, Re, Hh^Fp, Hh^Fp, Hh^Fp, Wwf, Gd^Fp, Hh^Fp, Hh^Fp
Xu, Xu, Uh, Xu, Uh, Xu, Xu, Gs^Fp, Rd, Hhd^Fp, Rd, Rd, Hhd, Gll^Fp, Rd, Rd, Gd^Fp, Hh^Fp, Gs, Chr, Urb^Vud, Urb, Urb, Urb^Vud, Urb, Urb, Urb^Vud, Chr, Hh^Fp, Hh^Fp, Hh, Gs, Gs^Es, Gs, Mm, Hh, Re, Hh, Hh, Hh, Mm, Wwf, Hh^Fp, Hh^Fp, Hh
Xu, Xu, Xu, Urb, Urb, Xu, Xu, Xu, Rd, Rd^Es, Hhd^Fp, Hh, Hh, Re^Vct, Rd, Ce, Ke, Gs, Hh^Fp, 1 Khr, Mm, Urb^Vud, Chw, Urb^Vud, Chw, Urb^Vud, Mm, 2 Khr, Gs, Gs, Gs, Gs, Gs, Gd^Fp, Hh, Re, Hh^Fmw, Gs^Vhh, Gs, Mm, Wwf, Wwf, Hh, Hh, Hh
Xu, Xu, Xu, Urb, Urb, Urb, Xu, Xu, Gs^Fp, Rd, Md, Mm, Hhd^Fp, Rd, Rd, Rd, Ce, Hh^Fp, Wwr, Wo, Wwf, Wwf, Ww, Chw, Ww, Ww, Wo, Ww, Wo, Chr, Gs, Gs^Vhh, Hh^Fp, Gd, Gd^Fdw, Re, Gd^Fdw, Gs^Fdw, Wwf, Wwf, Hh^Fp, Hh, Mm, Hh, Mm
Xu, Xu, Cud, Xu, Uu^Uf, Xu, Uu^Uf, Xu, Xu, Rd, Rd, Md, Hhd^Fp, Gll^Fp, Rd, Rd^Es, Ww, Wo, Wo, Wo, Wo, Wo, Ww, Ww, Ww, Wo, Wo, Wo, Wo, Ww, Wo, Hh^Fp, Gd^Fdw, Gd, Ss, Re, Ss, Gd^Fdw, Wwf, Wwf, Hh^Fp, Hh^Fp, Hh, Mm, Mm
Xu, Xu, Uh, Rb, Rb^Em, Uu^Uf, Ur, Uh^Em, Xu, Xu, Md, Rd, Rd, Rd, Ww^Bw|, Ww^Bw|, Ww^Bw\, Wo, Wo, Wo, Wo, Wwr, Ww, Ww, Ww, Ww, Wwf, Wo, Ww, Ww^Ewl, Ww, Ww, Ss, Gd^Fdw, Ss, Wwf^Ewf, Khr, Ss, Ss, Wwf, Hh^Fp, Hh^Fp, Hh, Mm, Mm
Xu, Uh, Ur, Uu, Ur, Uh, Ur^Edb, Uu^Uf, Uu^Uf, Xu, Rd, Rd^Es, Ww, Wwf, Ww, Ww^Bw\, Ww^Bw\, Ww^Bw\, Ww^Bw\, Ww, Chw, Wwf, Ww, Ww, Ww, Wwf, Chw, Wo, Wwf, Wo, Ww, Ss, Ww^Ewf, Ss, Ww^Ewf, Ss, Chs, Chs, Gd^Fdw, Gd^Fdw, Gd, Gs, Hh^Fp, Hh, Hh^Fp
Xu, Uu^Vu, Uu^Uf, Ur, Uu^Em, Ur, Ur, Uu^Em, Uu^Vud, Xu, Chw, Rd, Wo, Ww^Vm, Wo, Ww, Wwf, Ww^Bw\, Rd, Chr, Chr, Uu, Rr, Ww, Chr, Chr, Mm, Gs^Fp, Gg, Wo^Bw/r, Ww^Ewf, Ss, Ss, Ww^Ewf, Ss, Wwf^Ewf, Ss, Ss^Vhs, Gd^Fdw, Gd, Gs^Es, Gs, Hh^Fp, Hh^Fp, Hh^Fp
Xu, Xu, Rb, Uu^Uf, Uu^Em, Uu^Uf, Xu, Ur^Em, Wwf^Bw\r, Wwf, Ww, Ww, Ww, Wo, Ww, Wwf, Chw, Chr, Gs^Fp, Rd, Rd, Khr, Rr, Rr, Rr, Khr, Hh^Fp, Hh^Fp, Gg, Gs^Fmw, Gs^Fdw, Ww^Ewf, Wwf^Ewf, Wwf^Ewf, Ww^Ewf, Ww^Ewf, Ss, Co, Wwr, Gd^Fp, Wwf, Gs^Fp, Ww, Gs^Fp, Gs^Fp
Xu, Rb, Uh, Uh^Em, Uu^Uf, Xu, Xu, Wwf, Wwf, Wwf, Ww, Chw, Wwf, Wo, Gg, Wwf, Gg, Khr, Gg, Gs^Fp, Rd, Rr, Rr, Ch, Rr, Gg^Efm, Gg^Efm, Gg, Gs, Gs^Es, Ss, Ss, Ss, Ss, Ss, Ss, Ss, Co, Ss, Wwr, Wo, Wo, Ww, Wo, Wo
Xu, Xu, Ur, Uu^Uf, Xu, Xu, Ww, Ww, Ww, Wwf, Xu, Xu, Gg, Hh^Vhh, Gg, Gg, Hh^Fp, Gg, Rd, Rd^Es, Uu, Khw, Rr, Ch, Rd, Ch, Ch, Rr^Vhc, Gs, Gs, Ss^Vhs, Ss, Ss, Wwf^Ewf, Wwf^Ewf, Ss, Co, Co, Ww^Ewf, Wwr, Ww, Wo, Wo, Ww, Wo
Xu, Uh, Uu^Vu, Uu^Uf, Xu, Ww, Ww, Ww, Wwf, Wwf, Xu, Hh^Fp, Gg, Gg, Gs, Hh^Fp, Rd, Gs^Fp, Rd, Rr^Vhc, Ch, Ch, Rd, Rd^Br|, Rd, Ch, Kh, Rr, Hh, Hh^Fdw, Gs^Fdw, Ss, Ss, Ss, Wwf^Ewf, Ss, Wwf^Ewf, Ss, Mm, Mm, Hh, Ww, Mm, Ww, Ww
Wo, Wwf, Wwf, Wwf, Wwf, Ww, Ww, Ww, Wwf, Uh, Xu, Hh^Fp, Mm, Hh, Rd, Rd^Es, Hh, Rd, Gs^Fp, Gg^Efm, Gs^Fp, Gg, Rd, Rd^Br|, Rd, Gg, Gg, Gg, Hh, Hh^Fmw, Mm, Gs^Fdw, Xu, Chw, Ss, Ss, Ss, Chs, Xu, Mm^Xm, Xu, Mm^Xm, Xu, Mm, Mm
Wo, Wo, Ww, Ww, Wwf, Wwf, Ww, Ww, Ur, Uu^Vu, Xu, Xu, Xu, Cud, Cud, Xu, Xu, Xu, Xu, Gs^Fp, Xu, Gs^Fp, Cud, Cud^Br|, Cud, Hh^Fp, Xu, Mm, Xu, Xu, Xu, Xu, Xu, Wwf, Wwf, Wwf, Wwf, Uu^Uf, Uh, Xu, Cud, Xu, Kud, Xu, Xu
Ww, Ww, Ww, Ww, Xu, Wwf, Wwf, Uu^Uf, Ur, Uu, Wwf, Uu, Uh, Ur, Ur^Em, Xu, Xu, Xu, Xu, Xu, Xu, Cud, Urb, Urb^Br|, Urb, Xos, Xu, Xu, Urb, Xu, Xu, Xu, Xu, Xu, Wwf, Ss, Ss, Uu^Em, Uu^Vu, Xu, Cud^Br\, Cud, Cud, Uu, Xu
Ur, Ur^Uf, Ur^Em, Ur^Em, Xu, Wwf, Uu^Vu, Ur, Xu, Ur, Ur^Em, Uu, Uh, Ur, Ur, Uh, Uh, Xu, Xu, Xu, Uh, Urb, Urb, Urb^Br\, Urb^Br|, Xos, Xu, Xu, Xu, Xu, Xu, Xu, Xu, Xu, Uu^Uf, Ss, Wwf, Uh, Uh^Em, Xu, Xu, Cud^Br\, Cud^Br|, Kud, Xu
Ur, Ur, Xu, Xu, Xu, Xu, Uu, Ur^Br\, Ur^Br\, Uh, Uh, Ur, Uu, Uu^Vu, Ur, Uh, Ur^Em, Uu^Uf, Uu^Uf, Uu^Vu, Ur, Uh, Ur, Cud, Uu^Br|, Xos, Xos, Xu, Uu^Vu, Xu, Rb^Edb, Xu, Ur, Ur^Em, Ss^Vhs, Ss, Wwf, Uu^Uf, Uu^Uf, Uh, Xu, Uu^Vud, Ur^Br|, Uu^Vud, Xu
Xu, Ur, Xu, Xu, Uu^Uf, Xu, Xu, Uu^Uf, Uu^Uf, Ur^Br\, Ur^Br|, Ur, Ur, Ur, Uh, Ur, Uu, Ur, Ur, Ur, Uu, Ur, Uu, Cud, Uu^Br|, Uh, Xos, Uh, Rb^Edb, Uh, Uh, Xu, Ur, Uh, Uu, Ss, Ss, Uu^Uf, Xu, Xu, Xu, Uh, Uh^Br|, Uh, Xu
Xu, Xu, Uh, Uu^Vu, Uu, Uu^Uf, Xu, Cud, Cud, Kud, Cud^Br/, Cud, Uu, Qxu, Qxu, Uh, Cud, Uu, Uh, Uh, Uu^Uf, Uu^Vu, Ur, Cud, Ur^Br|, Uh, Xos, Rb, Uh, Uu, Uh^Edb, Xu, Xu, Xu, Uh, Chw, Khw, Wwf, Xu, Xu, Uh, Uh, Ur^Br|, Uh, Xu
Xu, Xu, Uh, Uh, Uu, Ur, Ur, Uu^Vud, Rb^Br/, Rb^Br/, Rb, Uu^Vud, Uu^Uf, Uu^Uf, Uu^Uf, Qxu, Uh, Cud, Xos, Xos, Xos, Xos, Uh, Kud, Ur^Br|, Uu^Vu, Xos, Xos, Xu, Uu^Vu, Xu, Xu, Xu, Xu, Ur, Wwf, Wwf, Chw, Uh, Xu, Uu^Uf, Uh, Ur^Br|, Xu, Xu
Xu, Xu, Xu, Ur^Em, Uu^Uf, Uu^Em, Uu^Br|, Cud^Br/, Rb, Ql, Rb, Cud, Uh, Ur^Em, Uu^Uf, Xos, Rb, Uh^Em, Uh^Em, Uu^Vu, Uu^Uf, Xos, Uh, Urb, Urb^Br|, Uu^Uf, Xos, Xos, Xu, Xu, Xu, Uu^Uf, Uu^Edb, Xu, Uu^Uf, Wwf, Uh, Ur^Em, Uu^Uf, Xu, Uu^Uf, Ur, Uh^Br|, Xu, Xu
Xu, Xu, Xu, Xu, Xu, Uu^Uf, Ur^Br\, Uu^Vud, Cud, Rb, Cud, Uu^Vud, Uu, Uh^Em, Uu^Uf, Xos, Uu^Uf, Uu^Em, Uu^Em, Uu^Uf, Uu^Uf, Xos, Uu, Uh, Urb^Br/, Uh, Xol, Xos, Xu, Uh, Uh, Uh^Edb, Uu^Uf, Xu, Uu^Vu, Wwf, Wwf, Uh^Em, Uu^Uf, Xu, Uu^Uf, Uu^Uf, Ur^Br|, Xu, Xu
Xu, Xu, Xu, Xu, Xu, Uu^Uf, Uu^Em, Cud^Br|, Ur, Kud, Ur, Cud, Uh, Ur^Em, Xos, Xos, Uu^Uf, Ur^Em, Uh^Em, Uu^Vu, Xol, Xol, Cud, Cud, Cud^Br|, Cud, Uu^Vud, Xol, Xol, Xu, Xu, Xu, Xu, Xu, Uu^Uf, Uu^Uf, Wwf, Ur^Em, Uu^Vu, Xu, Xu, Uu^Uf, Ur^Br|, Uu^Vu, Xu
Ur^Br\, Xu, Cud, Xu, Ur^Emf, Xu, Uh, Uh^Br|, Ur^Br\, Ur, Ur^Br\, Uu, Uu, Xos, Uu^Vu, Uu^Uf, Ur, Uu^Uf, Xol, Xol, Uh, Uu^Vud, Urb^Br\, Urb, Urb^Br/, Urb, Urb, Uh, Uh, Xol, Xol, Xu, Uh, Ur, Uu^Em, Wwf, Ur^Em, Uu^Uf, Uu^Uf, Xu, Xu, Uu^Uf, Ur^Br|, Uh, Xu
Ur, Ur^Br\, Cud^Br\, Ur^Emf, Ur^Br/, Ur^Emf, Ur^Br/, Ur^Br/, Ur, Uh^Br/, Ur, Ur^Br\, Ur^Br\, Cud, Uu^Br\, Ur, Uu, Xol, Uu^Vud, Uh, Urb^Br/, Urb^Br/, Urb, Urb^Br\, Uu^Vu, Urb, Xos, Urb, Uh, Uu, Uu^Vud, Uh, Uh, Cud, Cud, Wwf, Uu^Uf, Uu^Uf, Uh, Xu, Xu, Xu, Ur^Br|, Uh, Xu
Uu, Ur, Cud, Ur^Br/, Uu^Emf, Ur^Br\, Ur^Emf, Ur^Emf, Ur^Em, Uh^Em, Ur, Ur, Ur, Cud, Uu^Uf, Ur^Br\, Uh, Xos, Uh, Rb^Br|, Uh, Xos, Cud, Cud, Cud, Uh, Uh, Xos, Uu^Em, Ur, Uh, Cud, Uu^Vu, Uu^Uf, Kud, Cud, Uu^Uf, Uh, Xu, Xu, Xu, Uh, Ur^Br|, Uu^Vu, Xu
Uh, Uu, Kud, Cud, Uu^Emf, Uu^Vu, Uu^Uf, Uu^Emf, Ur^Uf, Ur^Edb, Ur^Uf, Uu, Uh, Xos, Xos, Uu^Br|, Rb, Cud, Rb^Br/, Rb^Br|, Uh, Xos, Cud, Uu^Vud, Cud, Cud, Uu^Vud, Xos, Uu^Uf, Ur^Em, Wwf, Cud, Wwf, Wwf, Xos, Xos, Xos, Xu, Xu, Xu, Uu^Uf, Ur^Br/, Uh, Xu, Xu
Xu, Uh, Xu, Uh^Em, Uu^Em, Uu^Uf, Uh^Em, Uh^Em, Xos, Xos, Xos, Uh, Uh, Xos, Uu^Vu, Uh^Br\, Uh^Br/, Cud, Uu^Vud, Rb^Br\, Rb^Br\, Xos, Uh, Kud, Uu^Uf, Kud, Xos, Xos, Uu^Uf, Uh, Wwf, Cud, Uu^Uf, Uu^Uf, Xos, Wwg, Wwg, Xos, Xu, Uu^Uf, Uh^Br/, Ur^Br|, Uu, Xu, Xu
Xu, Xu, Xu, Xu, Cud, Xu, Xu, Xos, Urb, Urb^Edb, Urb, Xos, Xos, Xos, Uh, Uu, Ur^Br|, Xos, Xos, Uu, Uh, Rb^Br\, Rb^Br\, Urb^Br|, Urb, Urb, Uu^Uf, Uu^Uf, Wwf, Wwf, Wwf, Uu^Uf, Xos, Xos, Xos, Wwg, Xos, Xos, Uh, Ur^Br/, Uu, Uh, Xu, Xu, Xu
Xu, Xu, Xu, Xu, Ur, Xu, Qxua^Xo, Xos, Xos, Urb, Urb^Edb, Xos, Xos, Uh, Uh, Uu^Vu, Ur^Br|, Uh, Uu, Xos, Xos, Uu^Vud, Uu, Urb^Br|, Wwf, Wwf, Wwg, Wwg, Wwg, Wwg, Wwf, Wwg, Wwf, Wwg, Xos, Wwg, Xol, Uh, Ur^Br/, Ur^Br|, Wwf, Wwf, Xu, Xu, Xu
Xu, Xu, Xu, Ur, Urb, Urb, Urb^Vud, Qxua^Xo, Qxua^Xo, Xos, Xos, Xos, Xu, Uh^Em, Uu^Uf, Xu, Uu^Uf, Uu^Br\, Ur^Br\, Uh, Uh, Xos, Uh, Urb^Br|, Wwf, Uu^Uf, Xos, Xos, Xos, Wwg^Vm, Wwg, Wwf^Edb, Wwg, Wwg^Vm, Xos, Xol, Kud, Ur^Br/, Uh, Wwf, Xu, Xu, Wwf, Xu, Wwf
Xu, Xu, Xu, Xu, Urb, Ur^Edb, Urb, Uh, Qxua^Xo, Qxua^Xo, Cud, Xu, Xu, Wwf, Uu^Uf, Uh^Em, Uu^Vu, Uu^Uf, Cud, Ur^Br\, Uu^Br\, Xos, Cud, Cud^Br|, Cud, Cud, Xos, Wwg, Wwg, Xos, Xos, Wwf, Xos, Xos, Cud, Cud^Vud, Cud, Cud^Br|, Uu, Wwf, Xu, Xu, Ur^Vu, Wwf, Urb^Br/
Xu, Xu, Xu, Xu, Xu, Ur, Ur, Urb, Urb, Urb^Edb, Cud^Edb, Xu, Xu, Wwf, Wwf, Uh^Em, Wwf, Uu^Uf, Cud, Ur, Rb, Cud^Br\, Cud^Br\, Cud^Br|, Cud, Cud, Uh, Xos, Xos, Xos, Uh, Uu^Uf, Uu^Uf, Uu^Uf, Uu^Uf, Cud, Cud^Br/, Cud^Br|, Kud, Xu, Xu, Ur, Ur^Br/, Urb^Br/, Urb
Xu, Xu, Xu, Xu, Cud^Edb, Urb, Urb, Urb^Edb, Uu^Vud, Qxua^Xo, Qxua^Xo, Urb, Urb, Cud, Cud^Edb, Wwf, Xu, Wwf, Wwf, Uh, Uu^Vud, Kud, Cud, Cud^Br\, Cud^Br\, Kud, Urb^Vud, Uh, Uu, Uu^Vud, Urb^Br/, Urb^Br/, Urb^Br\, Urb^Em, Urb^Br/, Urb^Br/, Cud^Br\, Cud^Vud, Xu, Xu, Urb^Br/, Urb^Br/, Ur, Urb^Em, Xu
Xu, Xu, Xu, Urb, Urb, Cud, Qxua^Xo, Qxua^Xo, Qxua^Xo, Qxua^Xo, Qxua^Xo, Qxua^Xo, Urb^Edb, Urb, Urb^Vud, Xu, Xu, Xu, Wwf, Uu^Em, Ur^Em, Ur, Uu^Vud, Kud, Uu^Vud, Urb^Br\, Urb^Br/, Urb^Br\, Urb^Br/, Urb^Br/, Cud, Urb, Uh, Urb^Br/, Uh, Uu^Uf, Uh, Cud^Br\, Urb^Br\, Urb^Br/, Urb^Vud, Urb^Br\, Ur^Em, Wwf, Xu
Xu, Xu, Xu, Xu, Ur, Urb, Urb^Vud, Qxua^Xo, Xu, Xu, Qxua^Xo, Uu, Urb, Ur, Uh, Xu, Xu, Xu, Xu, Wwf, Xu, Ur^Em, Uh, Uu, Uh, Uh, Wwf, Uh, Uh, Uu, Wwf, Cud, Xu, Uu^Vud, Xu, Uh, Xu, Urb, Ur^Em, Urb, Uu, Ur^Br|, Uu, Wwf, Xu
Xu, Xu, Xu, Urb, Xu, Ur^Edb, Uh, Qxua^Xo, Xu, Xu, Xu, Uh, Urb, Ur, Urb^Edb, Xu, Xu, Xu, Xu, Xu, Xu, Xu, Xu, Wwf, Xu, Wwf, Xu, Xu, Xu, Wwf, Xu, Xu, Xu, Xu, Xu, Xu, Xu, Xu, Ur, Uu, Wwf, Uu^Br|, Ur^Em, Xu, Xu
Xu, Xu, Xu, Xu, Xu, Xu, Xu, Qxua^Xo, Xu, Xu, Xu, Xu, Xu, Xu, Xu, Xu, Xu, Xu, Xu, Xu, Xu, Xu, Xu, Xu, Xu, Xu, Xu, Xu, Xu, Xu, Xu, Xu, Xu, Xu, Xu, Xu, Xu, Uu, Xu, Wwf, Ur^Em, Uu^Br|, Ur, Xu, Xu
Xu, Xu, Xu, Xu, Xu, Xu, Xu, Xu, Xu, Xu, Xu, Xu, Xu, Xu, Xu, Xu, Xu, Xu, Xu, Xu, Xu, Xu, Xu, Xu, Xu, Xu, Xu, Xu, Xu, Xu, Xu, Xu, Xu, Xu, Xu, Xu, Xu, Xu, Xu, Xu, Ur, Ur^Br|, Ur, Xu, Xu
