border_size=1
usage=map

Gs^Fds, Gs^Fds, Gs^Fds, Gs^Fds, Gs^Fds, Gg, Gg, Gs^Fds, Hh^Fds, Hh^Fds, Hh, Gs^Fds, Gs^Fds, Rb, Wwf, Gs^Fds, Gs^Fds, Gs^Fds, Rb, Gs^Fds, Gs^Fds, Gs^Fds, Gs^Fds, Gs^Fds, Rb, Rd, Gs^Fds, Gs^Fds, Gs^Fds, Gs^Fds, Gs^Fds, Gs^Fds, Gs^Fds, Gs^Fds, Re, Gs^Fds, Gs^Fds, Rd, Wwf, Wwf, Gs^Fds, Gs^Fds, Gs^Fds, Gs^Fds, Gs^Fds
Gs^Fds, Gs^Fds, Gg, Hh, Hh^Fds, Gs^Fds, Gg, Gs^Fds, Hh, Hh, Gg, Gg, Gg, Rb, Rb, Wwf, Wwf, Gs^Fds, Wwf, Gs^Fds, Gs^Fds, Gs^Fds, Gs^Fds, Gs^Fds, Wwf, Gs^Fds, Re^Vct, Gs^Fds, Gg, Gs^Fds, Gg, Gs^Fds, Re, Re, Hh^Fds, Gs^Fds, Wwf, Wwf, Re, Gs^Fds, Gg, Gs^Fds, Gs^Fds, Gs^Fds, Gs^Fds
Ww, Gs^Fds, Gs^Fds, Hh, Hh, Gg, Gs^Fds, Gg, Hh, Gg, Gs^Fds, Gs^Fds, Gs^Fds, Gg^Vh, Re, Rb^Es, Rb, Wwf, Rb, Wwf, Wwf, Wwf, Wwf, Wwf, 3 Ke, Wwf, Wwf, Gg, Wwf, Gg, Re, Re^Es, Gg, Hh, Wwf, Wwf, Hh, Gg, Re^Es, Hh^Fds, Gg, Gg, Wwf, Gs^Fds, Wwf
Wo, Wo, Ww, Ww, Ww, Gs^Fds, Gs^Fds, Gg, Gs^Fds, Gg, Gg, Gs^Fds, Gg, Re, Gs^Fds, Hh^Fms, Hh^Fms, Rb, Rb, Rb, Rb, Gg^Vh, Ce, Ce, Ce, Ce, Ce, Wwf, Hh^Fds, Wwf, Wwf, Wwf, Wwf, Wwf, Hh, Wwf, Wwf, Gg, Wwf, Wwf, Wwf, Wwf, Gg, Wwf, Gs^Fds
Ww, Wo, Wo, Wo, Wo, Wo, Ww, Ww, Wo, Hh, Hh^Fds, Gs^Fds, Ce, 4 Ke, Ce, Hh, Hh, Gg, Gg^Wm, Rb, Rb, Rb, Rb^Ecf, Gs^Fds, Gs^Fds, Wwf, Gs^Fds, Gs^Fds, Re, Re^Edt, Gg^Eff, Gs^Fds, Gs^Fds, Gg^Es, Gg, Hh, Gg, Wwf, 5 Ke, Re^Vct, Ce, Gg, Gg, Gs^Fds, Gs^Fds
Mm^Xm, Mm^Xm, Mm, Ww, Wo, Ww, Wo, Wo, Ww, Ww, Gs^Fds, Gg, Ce, Ce, Ce, Gg, Rb^Gvs, Gg^Vh, Rb^Gvs, Gg, Hh, Rb^Es, Rb, Hh^Fds, Rb, Wwf, Wwf, Re, Gg^Vh, Gg^Eff, Rb^Gvs, Rb^Gvs, Rb^Gvs, Gg^Eff, Gg^Eff, Gg, Gg^Edt, Ce, Gg, Ce, Ss^Vhs, Gg, Ww, Wo, Wo
Hh, Mm^Xm, Hh, Mm, Mm^Xm, Mm, Ww, Wo, Ww, Ww, Wo, Gg, Wwf, Wwf, Rb^Gvs, Rb^Gvs, Rb^Gvs, Rb^Gvs, Rb^Gvs, Rb^Gvs, Rb^Gvs, Hh, Rb, Rb^Es, Rb, Rb, Wwf, Gg, Gg, Rb^Gvs, Rb^Gvs, Rb^Gvs, Rb^Gvs, Rb^Gvs, Rb^Gvs, Gg, Ce, Ce, Gg, Gg, Ww, Ww, Ww, Ww, Wo
Rd, Rd, Rd, Hh, Hh, Mm, Mm, Mm, Hh^Fp, Ww, Wo, Wo, Wwf, Ce, Ww, Rb^Gvs, Ww^Vm, Rb^Gvs, Hh, Rb^Gvs, Hh^Fp, Gg, Ww^Bw|, Ww^Bw|, Ww^Bw|, Gg, Hh^Fp, Wwf, Gg, Gg, Gg^Wm, Rb^Gvs, Rb^Gvs, Rb^Gvs, Gs^Fds, Gg, Gg^Vh, Gg, Hh, Gg, Ww, Wo, Wo, Wo, Gs^Fds
Mm^Xm, Hh, Mm, Rd, Rd, Rd, Rd, Hh^Fp, Hh^Fp, Ww, Gs^Fp, Ww, Wwf, Ww, Wo, Ww, Ww, Wwf, Wwf, Wwf, Ww, Ww, Ww^Bw|, Ww^Bw|, Ww^Bw|, Ww, Ww, Ww, Ww, Wwf, Ww, Gg, Wwf, Gs^Fds, Wo, Gs^Fds, Ww, Gg, Wwf, Ww, Wo, Wo, Ww, Ww, Gs^Fms
Mm^Xm, Mm^Xm, Mm^Xm, Mm, Hh^Fp, Rd^Es, Rd, Rd, Rd^Es, Hh, Rd, Wwf, Wwf, Ww, Wo, Wo, Ww, Ww, Wo, Ww, Wo, Wo, Ww^Bw|, Ww^Bw|, Ww^Bw|, Wo, Wo, Wo, Ww^Vm, Ww, Wo, Ww, Wwf, Wwf, Wo, Wo, Wo, Ww, Wwf, Ww, Ww, Wo, Gs^Fms, Gs^Fms, Gs^Fms
Mm^Xm, Mm^Xm, Mm^Xm, Mm, Hh^Fp, Hh^Fp, Gg, Rd, Rd, Rd, Rd, Rd, Rd, Gs^Vl, Gd^Fp, Wo, Gs, Wwf, Chs, Ss, Ss, Ww, Ww^Bw|, Ww^Bw|, Ww^Bw|, Ww, Ss, Ww, Wwf, Ww, Wo, Wo, Ww, Ww, Ww, Ww, Ww, Wwf, Ww, Ww, Ww^Vm, Ww, Gs, Gll^Fms, Gs^Fms
Mm^Xm, Mm^Xm, Mm^Xm, Mm, Hh^Fp, Hh^Fp, Gs^Fp, Gg^Vh, Rd, Rd, Hhd, Rd^Es, Rd, Rd, Rd, Gd^Fp, Rr^Vht, Gs^Fp, Gs^Fp, Ss, Ss^Vhs, Wwf^Edb, Chw, Khw, Chw, Wwf^Edb, Ss^Vhs, Ss, Chs, Wo, Wo, Wwf, Wwf, Ww, Gs^Fp, Ww, Wwf, Re, Gll^Fp, Gll^Fp, Gll^Fp, Wwf, Gs^Fp, Gs^Fms, Gll^Fms
Xu, Xu, Xu, Xu, Xu, Xu, Xu, Gg, Rd, Hhd^Fp, Gll^Fp, Rd, Gll^Fp, Rd^Es, Rd, Rd, Gd^Fp, Rr, Rr, Gs, Chr, Chw, Urb^Vud, Chw, Urb^Vud, Chw, Chr, Gs^Fp, Hh^Fp, Gs, Gs^Fp, Gs^Fp, Gs, Gs^Vhhr, Gs^Fp, Gs^Fp, Re, Re, Hh^Fp, Hh^Fp, Hh^Fp, Wwf, Gd^Fp, Hh^Fp, Hh^Fp
Xu, Xu, Xu, Xu, Xu, Xu, Xu, Gs^Fp, Rd, Hhd^Fp, Rd, Rd, Hhd, Gll^Fp, Rd, Rd, Gd^Fp, Hh^Fp, Gs, Chr, Urb^Vud, Urb, Urb, Urb^Vud, Urb, Urb, Urb^Vud, Chr, Hh^Fp, Hh^Fp, Hh, Gs, Gs^Es, Gs, Mm, Hh, Re, Hh, Hh, Hh, Mm, Wwf, Hh^Fp, Hh^Fp, Hh
Xu, Xu, Xu, Xu, Xu, Xu, Xu, Xu, Rd, Rd^Es, Hhd^Fp, Hh, Hh, Re^Vct, Rd, Ce, Ke, Gs, Hh^Fp, 1 Khr, Mm, Urb^Vud, Chw, Urb^Vud, Chw, Urb^Vud, Mm, 2 Khr, Gs, Gs, Gs, Gs, Gs, Gd^Fp, Hh, Re, Hh^Fmw, Gs^Vhh, Gs, Mm, Wwf, Wwf, Hh, Hh, Hh
Xu, Xu, Xu, Xu, Xu, Xu, Xu, Xu, Gs^Fp, Rd, Md, Mm, Hhd^Fp, Rd, Rd, Rd, Ce, Hh^Fp, Ww, Wo, Wwf, Wwf, Ww, Chw, Ww, Ww, Wo, Wo, Wo, Chr, Gs, Gs^Vhh, Hh^Fp, Gd, Gd^Fdw, Re, Gd^Fdw, Gs^Fdw, Wwf, Wwf, Hh^Fp, Hh, Mm, Hh, Mm
Xu, Xu, Cud, Xu, Uu^Uf, Xu, Uu^Uf, Xu, Xu, Rd, Rd, Md, Hhd^Fp, Gll^Fp, Rd, Rd^Es, Ww, Wo, Wo, Wo, Wo, Wo, Ww, Ww, Ww, Wo, Wo, Wo, Wo, Wo, Wo, Hh^Fp, Gd^Fdw, Gd, Ss, Re, Ss, Gd^Fdw, Wwf, Wwf, Hh^Fp, Hh^Fp, Hh, Mm, Mm
Xu, Xu, Uh, Rb, Rb, Uu^Uf, Ur, Uh, Xu, Xu, Md, Rd, Rd, Rd, Ww^Bw|, Ww^Bw|, Ww^Bw\, Wo, Wo, Wo, Wo, Ww, Ww, Ww, Ww, Ww, Wwf, Wo, Ww, Ww, Ww, Ww, Ss, Gd^Fdw, Ss, Wwf^Ewf, Khr, Ss, Ss, Wwf, Hh^Fp, Hh^Fp, Hh, Mm, Mm
Xu, Uh, Ur, Uu, Ur, Uh, Ur, Uu^Uf, Uu^Uf, Xu, Rd, Rd^Es, Ww, Wwf, Ww, Ww^Bw\, Ww^Bw\, Ww^Bw\, Ww^Bw\, Ww, Chw, Wwf, Ww, Ww, Ww, Wwf, Chw, Wo, Wwf, Wo, Ww, Ss, Ww^Ewf, Ss, Ww^Ewf, Ss, Chs, Chs, Gd^Fdw, Gd^Fdw, Gd, Gs, Hh^Fp, Hh, Hh^Fp
Xu, Uu^Vu, Uu^Uf, Ur, Uu, Ur, Ur, Uu, Uu^Vud, Xu, Chw, Rd, Wo, Ww^Vm, Wo, Ww, Wwf, Ww^Bw\, Rd, Chr, Chr, Uu, Rr, Ww, Chr, Chr, Mm, Gs^Fp, Gg, Wo, Wwf, Ss, Ss, Ww^Ewf, Ss, Wwf^Ewf, Ss, Ss^Vhs, Gd^Fdw, Gd, Gs^Es, Gs, Hh^Fp, Hh^Fp, Hh^Fp
Xu, Xu, Rb, Uu^Uf, Uu, Uu^Uf, Xu, Ur, Ww, Wwf, Ww, Ww, Ww, Wo, Ww, Wwf, Chw, Chr, Gs^Fp, Rd, Rd, Khr, Rr, Rr, Rr, Khr, Hh^Fp, Hh^Fp, Gg, Gs^Fmw, Gs^Fdw, Ww^Ewf, Wwf^Ewf, Wwf^Ewf, Ww^Ewf, Ww^Ewf, Ss, Co, Ww, Gd^Fp, Wwf, Gs^Fp, Ww, Gs^Fp, Gs^Fp
Xu, Rb, Uh, Uh, Uu^Uf, Xu, Xu, Wwf, Wwf, Wwf, Ww, Chw, Wwf, Wo, Gg, Wwf, Gg, Khr, Gg, Gs^Fp, Rd, Rr, Rr, Ch, Rr, Gg, Gg, Gg, Gs, Gs^Es, Ss, Ss, Ss, Ss, Ss, Ss, Ss, Co, Ss, Ww, Wo, Wo, Ww, Wo, Wo
Xu, Xu, Ur, Uu^Uf, Xu, Xu, Ww, Ww, Ww, Wwf, Xu, Xu, Gg, Hh^Vhh, Gg, Gg, Hh^Fp, Gg, Rd, Rd, Uu, Khw, Rr, Ch, Rd, Ch, Ch, Rr^Vhc, Gs, Gs, Ss^Vhs, Ss, Ss, Wwf^Ewf, Wwf^Ewf, Ss, Co, Co, Ww, Wwr, Ww, Wo, Wo, Ww, Wo
Xu, Uh, Uu^Vu, Uu^Uf, Xu, Ww, Ww, Ww, Wwf, Wwf, Xu, Hh^Fp, Gg, Gg, Gg^Es, Hh^Fp, Rd, Gs^Fp, Rd, Rr^Vhc, Ch, Ch, Rd, Rd, Rd, Ch, Kh, Rr, Hh, Hh^Fdw, Gs^Fdw, Ss, Ss, Ss, Wwf^Ewf, Ss, Wwf^Ewf, Ss, Mm, Mm, Hh, Ww, Mm, Ww, Ww
Wo, Wwf, Wwf, Wwf, Wwf, Ww, Ww, Ww, Wwf, Uh, Xu, Hh^Fp, Mm, Hh, Rd, Rd, Hh, Rd, Gs^Fp, Gg, Gs^Fp, Gg, Rd, Rd, Rd, Gg, Gg, Gg, Hh, Hh^Fmw, Mm, Gs^Fdw, Xu, Chw, Ss, Ss, Ss, Chs, Xu, Mm^Xm, Xu, Mm^Xm, Xu, Mm, Mm
Wo, Wo, Ww, Ww, Wwf, Wwf, Ww, Ww, Ur, Uu^Vu, Xu, Xu, Xu, Cud, Cud, Xu, Xu, Xu, Xu, Gs^Fp, Xu, Gs^Fp, Cud, Cud, Cud, Hh^Fp, Xu, Mm, Xu, Xu, Xu, Xu, Xu, Wwf, Wwf, Wwf, Wwf, Uu^Uf, Uh, Xu, Cud, Xu, Kud, Xu, Xu
Ww, Ww, Ww, Ww, Xu, Wwf, Wwf, Uu^Uf, Ur, Uu, Ur, Uu, Uh, Ur, Ur, Xu, Xu, Xu, Xu, Xu, Xu, Cud, Urb, Urb, Urb, Xos, Xu, Xu, Xu, Xu, Xu, Xu, Xu, Xu, Wwf, Ss, Ss, Uu, Uu^Vu, Xu, Cud, Cud, Cud, Uu, Xu
Xu, Xu, Xu, Xu, Xu, Wwf, Uu^Vu, Ur, Xu, Ur, Ur, Uu, Uh, Ur, Ur, Uh, Uh, Xu, Xu, Xu, Uh, Urb, Urb, Urb, Urb, Xos, Xu, Xu, Xu, Xu, Xu, Xu, Xu, Xu, Uu^Uf, Ss, Wwf, Uh, Uh, Xu, Xu, Cud, Cud, Kud, Xu
Xu, Xu, Xu, Xu, Xu, Xu, Uu, Ur, Ur, Uh, Uh, Ur, Uu, Uu^Vu, Ur, Uh, Ur, Uu^Uf, Uu^Uf, Uu^Vu, Ur, Uh, Ur, Cud, Uu, Xos, Xos, Xu, Uu^Vu, Xu, Rb, Xu, Ur, Ur, Ss^Vhs, Ss, Wwf, Uu^Uf, Uu^Uf, Uh, Xu, Uu^Vud, Ur^Br|, Uu^Vud, Xu
Xu, Xu, Xu, Xu, Uu^Uf, Xu, Xu, Uu^Uf, Uu^Uf, Ur, Ur, Ur, Ur, Ur, Uh, Ur, Uu, Ur, Ur, Ur, Uu, Ur, Uu, Cud, Uu, Uh, Xos, Uh, Rb, Uh, Uh, Xu, Ur, Uh, Uu, Ss, Ss, Uu^Uf, Xu, Xu, Xu, Uh, Uh^Br|, Uh, Xu
Xu, Xu, Uh, Uu^Vu, Uu, Uu^Uf, Xu, Cud, Cud, Kud, Cud, Cud, Uu, Qxu, Qxu, Uh, Cud, Uu, Uh, Uh, Uu^Uf, Uu^Vu, Ur, Cud, Ur, Uh, Xos, Rb, Uh, Uu, Uh, Xu, Xu, Xu, Uh, Chw, Khw, Wwf, Xu, Xu, Uh, Uh, Ur^Br|, Uh, Xu
Xu, Xu, Uh, Uh, Uu, Ur, Ur, Uu^Vud, Rb, Rb, Rb, Uu^Vud, Uu^Uf, Uu^Uf, Uu^Uf, Qxu, Uh, Cud, Xos, Xos, Xos, Xos, Uh, Kud, Ur, Uu^Vu, Xos, Xos, Xu, Uu^Vu, Xu, Xu, Xu, Xu, Ur, Wwf, Wwf, Chw, Uh, Xu, Uu^Uf, Uh, Ur^Br|, Xu, Xu
Xu, Xu, Xu, Ur, Uu^Uf, Uu, Uu, Cud, Rb, Ql, Rb, Cud, Uh, Uu^Uf, Uu^Uf, Xos, Rb, Uh, Uh, Uu^Vu, Uu^Uf, Xos, Uh, Urb, Urb, Uu^Uf, Xos, Xos, Xu, Xu, Xu, Uu^Uf, Uu, Xu, Uu^Uf, Wwf, Uh, Ur, Uu^Uf, Xu, Uu^Uf, Uu^Uf, Uh^Br|, Xu, Xu
Xu, Xu, Xu, Xu, Xu, Uu^Uf, Ur, Uu^Vud, Cud, Rb, Cud, Uu^Vud, Uu, Uh, Uu^Uf, Xos, Uu^Uf, Uu, Uu, Uu^Uf, Uu^Uf, Xos, Uu, Uh, Urb, Uh, Xol, Xos, Xu, Uh, Uh, Uh, Uu^Uf, Xu, Uu^Vu, Wwf, Wwf, Uh, Uu^Uf, Xu, Uu^Uf, Uu^Uf, Ur^Br|, Xu, Xu
Xu, Xu, Xu, Xu, Xu, Uu^Uf, Uu, Cud, Ur, Kud, Ur, Cud, Uh, Uh, Xos, Xos, Uu^Uf, Ur, Uh, Uu^Vu, Xol, Xol, Cud, Cud, Cud, Cud, Uu^Vud, Xol, Xol, Xu, Xu, Xu, Xu, Xu, Uu^Uf, Uu^Uf, Wwf, Ur, Uu^Vu, Xu, Xu, Uu^Uf, Ur^Br|, Uu^Vu, Xu
Ur, Xu, Cud, Xu, Ur^Emf, Xu, Uh, Uh, Ur, Ur, Ur, Uu, Uu, Xos, Uu^Vu, Uu^Uf, Ur, Uu^Uf, Xol, Xol, Uh, Uu^Vud, Urb, Urb, Urb, Urb, Urb, Uh, Uh, Xol, Xol, Xu, Uh, Ur, Uu, Wwf, Ur, Uu^Uf, Uu^Uf, Xu, Xu, Uu^Uf, Ur^Br|, Uh, Xu
Ur, Ur, Ur, Ur, Ur, Ur^Emf, Ur, Ur, Ur, Uh, Ur, Ur, Ur, Cud, Uu, Ur, Uu, Xol, Uu^Vud, Uh, Urb, Urb, Urb, Urb, Uu^Vu, Urb, Xos, Urb, Uh, Uu, Uu^Vud, Uh, Uh, Cud, Cud, Wwf, Uu^Uf, Uu^Uf, Uh, Xu, Xu, Xu, Ur^Br|, Uh, Xu
Uu, Ur, Cud, Ur, Uu, Ur, Ur, Ur, Ur, Uh, Ur, Ur, Ur, Cud, Uu^Uf, Ur, Uh, Xos, Uh, Rb, Uh, Xos, Cud, Cud, Cud, Uh, Uh, Xos, Uu, Ur, Uh, Cud, Uu^Vu, Uu^Uf, Kud, Cud, Uu^Uf, Uh, Xu, Xu, Xu, Uh, Ur^Br|, Uu^Vu, Xu
Uh, Uu, Kud, Cud, Uu, Uu^Vu, Uu^Uf, Uu, Ur^Uf, Ur, Ur^Uf, Uu, Uh, Xos, Xos, Uu, Rb, Cud, Rb, Rb, Uh, Xos, Cud, Uu^Vud, Cud, Cud, Uu^Vud, Xos, Uu^Uf, Ur, Wwf, Cud, Wwf, Wwf, Xos, Xos, Xos, Xu, Xu, Xu, Uu^Uf, Ur^Br/, Uh, Xu, Xu
Xu, Uh, Xu, Uh, Uh, Uu^Uf, Uh, Uh, Xos, Xos, Xos, Uh, Uh, Xos, Uu^Vu, Uh, Uh, Cud, Uu^Vud, Rb, Rb, Xos, Uh, Kud, Uu^Uf, Kud, Xos, Xos, Uu^Uf, Uh, Wwf, Cud, Uu^Uf, Uu^Uf, Xos, Wwg, Wwg, Xos, Xu, Uu^Uf, Uh^Br/, Ur^Br|, Uu, Xu, Xu
Xu, Xu, Xu, Xu, Xu, Xu, Xu, Xos, Urb, Urb, Urb, Xos, Xos, Xos, Uh, Uu, Ur, Xos, Xos, Uu, Uh, Rb, Rb, Urb, Urb, Urb, Uu^Uf, Uu^Uf, Wwf, Wwf, Wwf, Uu^Uf, Xos, Xos, Xos, Wwg, Xos, Xos, Uh, Ur^Br/, Uu, Uh, Xu, Xu, Xu
Xu, Xu, Xu, Xu, Xu, Xu, Xu, Xos, Xos, Urb, Urb, Xos, Xos, Uh, Uh, Uu^Vu, Ur, Uh, Uu, Xos, Xos, Uu^Vud, Uu, Urb, Wwf, Wwf, Wwg, Wwg, Wwg, Wwg, Wwf, Wwg, Wwf, Wwg, Xos, Wwg, Xol, Uh, Ur^Br/, Ur^Br|, Xu, Xu, Xu, Xu, Xu
Xu, Xu, Xu, Xu, Xu, Xu, Xu, Xu, Xu, Xos, Xos, Xos, Xu, Uh, Uu^Uf, Xu, Uu^Uf, Uu, Ur, Uh, Uh, Xos, Uh, Urb, Wwf, Uu^Uf, Xos, Xos, Xos, Wwg^Vm, Wwg, Wwf, Wwg, Wwg^Vm, Xos, Xol, Kud, Ur^Br/, Uh, Xu, Xu, Xu, Xu, Xu, Xu
Xu, Xu, Xu, Xu, Xu, Xu, Xu, Xu, Xu, Xu, Xu, Xu, Xu, Xu, Uu^Uf, Uh, Uu^Vu, Uu^Uf, Cud, Ur, Uu, Xos, Cud, Cud, Cud, Cud, Xos, Wwg, Wwg, Xos, Xos, Wwf, Xos, Xos, Cud, Uu^Vud, Cud, Cud, Uu, Xu, Xu, Xu, Xu, Xu, Xu
Xu, Xu, Xu, Xu, Xu, Xu, Xu, Xu, Xu, Xu, Xu, Xu, Xu, Xu, Xu, Uh, Xu, Uu^Uf, Cud, Ur, Rb, Cud, Cud, Cud, Cud, Cud, Uh, Xos, Xos, Xos, Uh, Uu^Uf, Uu^Uf, Uu^Uf, Uu^Uf, Cud, Cud, Cud, Kud, Xu, Xu, Xu, Xu, Xu, Xu
Xu, Xu, Xu, Xu, Xu, Xu, Xu, Xu, Xu, Xu, Xu, Xu, Xu, Xu, Xu, Xu, Xu, Xu, Xu, Uh, Uu^Vud, Kud, Cud, Cud, Cud, Kud, Urb^Vud, Uh, Uu, Uu^Vud, Urb, Urb, Urb, Urb, Urb, Urb, Cud, Uu^Vud, Xu, Xu, Xu, Xu, Xu, Xu, Xu
Xu, Xu, Xu, Xu, Xu, Xu, Xu, Xu, Xu, Xu, Xu, Xu, Xu, Xu, Xu, Xu, Xu, Xu, Xu, Uh, Uh, Uh, Uu^Vud, Kud, Uu^Vud, Urb, Urb, Urb, Urb, Urb, Cud, Urb, Uh, Urb, Uh, Uu^Uf, Uh, Cud, Xu, Xu, Xu, Xu, Xu, Xu, Xu
Xu, Xu, Xu, Xu, Xu, Xu, Xu, Xu, Xu, Xu, Xu, Xu, Xu, Xu, Xu, Xu, Xu, Xu, Xu, Xu, Xu, Uh, Uh, Uh, Uh, Uh, Xu, Uh, Uh, Uu, Xu, Cud, Xu, Uu^Vud, Xu, Uh, Xu, Xu, Xu, Xu, Xu, Xu, Xu, Xu, Xu
Xu, Xu, Xu, Xu, Xu, Xu, Xu, Xu, Xu, Xu, Xu, Xu, Xu, Xu, Xu, Xu, Xu, Xu, Xu, Xu, Xu, Xu, Xu, Xu, Xu, Xu, Xu, Xu, Xu, Xu, Xu, Xu, Xu, Xu, Xu, Xu, Xu, Xu, Xu, Xu, Xu, Xu, Xu, Xu, Xu
Xu, Xu, Xu, Xu, Xu, Xu, Xu, Xu, Xu, Xu, Xu, Xu, Xu, Xu, Xu, Xu, Xu, Xu, Xu, Xu, Xu, Xu, Xu, Xu, Xu, Xu, Xu, Xu, Xu, Xu, Xu, Xu, Xu, Xu, Xu, Xu, Xu, Xu, Xu, Xu, Xu, Xu, Xu, Xu, Xu
Xu, Xu, Xu, Xu, Xu, Xu, Xu, Xu, Xu, Xu, Xu, Xu, Xu, Xu, Xu, Xu, Xu, Xu, Xu, Xu, Xu, Xu, Xu, Xu, Xu, Xu, Xu, Xu, Xu, Xu, Xu, Xu, Xu, Xu, Xu, Xu, Xu, Xu, Xu, Xu, Xu, Xu, Xu, Xu, Xu
