border_size=1
usage=map

Gll^Ftr, Wwt, Gll^Ftr, Gll^Ftr, Gll^Ftr, Gs^Fp, Gll^Ftr, Gll^Ftr, Hh^Ftr, Hh^Ftr, Gll^Ftr, Hh^Ftr, Rb, Rb, Rb^Edb, Gll^Fp, Hhd, Gll^Fp, Ww, Gll^Fp, Hh^Ftp, Gs^Ftp, Gs^Ftp, Gs^Fp, Gs^Ftp, Gd^Ftp, Gd^Ftp
Gll^Ftr, Wwt, Wwt, Gll^Efm, Gll^Ftr, Gll^Fet, Gll^Ftr, Hhd, Hhd, Gll^Ftr, Gll, Gll^Ftr, Rb^Edb, Rb, Rb^Edb, Rb, Rb^Edb, Ww, Gll^Fp, Gg^Efm, Gg^Efm, Gg^Efm, Gs^Fet, Gs^Ftp, Gd, Gd, Gd^Ftp
Hh^Ftr, Gll^Ftr, Gll^Ftr, Wwt, Gll^Ftr, Gll^Efm, Gll^Efm, Hhd, Rb, Gll^Vl, Rb, Gll^Ftr, Ce, Ce, Ce, Hhd, Gd, Ww^Bw\, Ket, Gs, Hh, Gs^Fp, Gs, Hhd, Gd^Edb, Hhd, Gd^Ftp
Hhd^Ftr, Hhd, Gll, Wwf, Wwt, Gll^Efm, Md, Rb, Gll^Fp, Rb, Gll, Ket, Rb, Rb, Rb, Ket, Gd^Vl, Ww, Ww, Re, Re, Hh, Gs, Hhd, Gd, Gd, Gd
Wwt, Hhd, Gll^Ftr, Hhd, Ww^Vm, Wwt, Wwt^Bw/, Wwt^Bw|, Wwt, Hhd, Wwf, Hhd, Wwt^Bw|r, Wwt^Bw|, Wwt^Bw|r, Gll^Fp, Wwt, Hhd, Ww, Gs^Fp, Re^Es, Gs^Fp, Gg^Ve, Gd, Gd^Ftd, Gd^Ftd, Hd
Wot, Wwt, Wwt, Wwrt, Wot, Wwt, Wwt^Bw|, Wwt, Wwt, Wwt, Wwt, Wwf, Wwt, Wwt^Bw|, Wwt^Bw|, Wwrt, Wwt, Ww, Wwt, Gg^Fet, Wwf, Re, Md, Hhd, Hhd, Hd, Hd
Wot, Wot, Wot, Wot, Wwt, Wwt, Wo^Bw|, Wwrt, Wwt, Wot, Wot, Wwf, Wwt^Bw|r, Wwt^Bw|, Wwt^Bw|, Wwt, Wot, Wwt, Wot, Wot, Wwf, Wwf, Wwt, Hhd, Wwrt, Ds, Ds
Wwt, Wwt, Wwrt, Wot, Wwt, Wwt, Chw, Wwrt, Gll^Fp, Wwt, Hhd^Fp, Wwt, Wwt^Bw|, Wwt^Bw|, Chw, Wwt, Wwt, Wot, Wot, Ww, Wwf, Wo, Wo, Wwt, Wo, Wwt^Vm, Ds
Ds, Ds, Ds, Wwt, Gll^Fp, Md, Rd^Es, Gd^Vht, Rd, Hhd, Gll^Fp, Chw, Chr, Rr, Khw, Chw, Gll^Fp, Hhd, Gll^Fdf, Wwrg, Chw, Wo, Ww, Wo, Ww, Ww, Ww
Ds, Ds, Hhd^Vhh, Hhd, Gll^Fp, Rd, Gll^Fmf, Rd, Rb^Gvs, Rd, Rd, Gll^Fp, Re, Rr, Rr, Rr^Vhc, Md, Gll, Gll^Fdf, Gd, Chr, Khw, Hhd, Ww, Ww, Wo, Wo
Hhd, Ds, Hhd, Ch, Ch, Rd, Gd, Gd^Wm, Rb^Gvs, Rb^Gvs, Hhd, Rd, Re, Chr, Rr, Hhd, Rb^Gvs, Rb^Gvs, Rb^Gvs, Gd^Wm, Gll^Fmf, Gd, Ss^Vhs, Ss, Ss, Ww, Wo
Md^Xm, Md^Xm, Md^Xm, Md^Xm, Kh, Rr, Ch, Md^Xm, Md, Rb^Gvs, Hhd, Gd^Vh, Re^Es, Re, Rr, Rb^Gvs, Rb^Gvs, Rb^Gvs, Gd^Vh, Rb^Gvs, Gd, Ss, Ss, Ss, Ss, Ww, Ww
Md, Md^Xm, Md^Xm, Md^Xm, Hhd, Rr, Gll^Fp, Md^Xm, Md^Xm, Md^Xm, Md^Xm, Gll^Fp, Ch, Re, Ch, Md^Xm, Md^Xm, Md, Md^Xm, Md^Xm, Md^Xm, Wwf, Chs, Ss, Md^Xm, Ss, Ss
Md, Md^Xm, Gll^Fp, Gll^Fp, Re, Re, Gd^Efm, Md, Md^Xm, Md^Xm, Md^Xm, Md^Xm, Re, Re, Rp, Md^Xm, Md^Xm, Md^Xm, Md^Xm, Md^Xm, Md, Chw, Wwf, Md^Xm, Md, Md^Xm, Md
Md, Md, Hhd, Gd^Vh, Re^Es, Gll^Fmf, Hhd, Ch, Gd^Vh, Md^Xm, Hhd, Hhd, Re, Gll^Fet, Rp, Gll^Fp, Gll^Fdf, Md, Gll^Fp, Hhd, Gd^Vh, Wwf, Rb, Hhd, Md, Md, Md
Md^Xm, Hhd^Fp, Hhd, Gd, Ke, Re, Re, Gs^Efm, Re, Gll^Fmf, Gll^Fp, Hhd, Re, Re, Ch, Hhd, Gd^Vh, Hhd, Wwf^Bw/, Rb, Rb, Wwf^Bw/, Gll^Fp, Hhd, Md^Xm, Md^Xm, Md
Md^Xm, Md^Xm, Md^Xm, Gll^Fp, Hhd, Ce, Hhd, Re, Gd, Re, Re, Gd^Vl, Re, Ch, Kh, Gd, Re, Re, Wwf, Wwf, Wwf, Wwf, Gs^Em, Gll^Fmf, Md, Md^Xm, Hhd
Md^Xm, Md^Xm, Md^Xm, Gll^Fp, Gd, Gd^Em, Gd, Gll^Fmf, Hhd, Ch, Gd, Re^Es, Re, Rr, Rr, Ch, Hhd, Gll^Fdf, Wwf, Wwf, Hhd^Vhc, Ww, Hhd, Gll^Fdf, Md^Xm, Md^Xm, Hhd
Md^Xm, Md^Xm, Md^Xm, Md^Xm, Md, Gll^Fp, Md^Xm, Hhd, Gd, Gd^Fet, Gd, Hhd, Rr, Rr, Rr, Gs^Efm, Wwf, Wwf, Wwf, Ww, Rb^Gvs, Md, Md^Xm, Md^Xm, Md, Md, Hhd^Ftr
Md^Xm, Md^Xm, Md^Xm, Md^Xm, Md^Xm, Md^Xm, Md^Xm, Md, Md, Gll^Fp, Ch, Gd, Ch, Kh, Ch, Gs^Efm, Ch, Wwf, Gll^Fmf, Rb^Gvs, Rb^Gvs, Hhd, Md^Xm, Md, Md, Hhd^Ftr, Gll^Ftr
Ql, Ql, Ql, Md^Xm, Ql, Md^Xm, Md^Xm, Md^Xm, Md^Xm, Hhd, Hhd^Vhh, Ch, Ch, Ch, Ch, Ch, Hhd^Vhc, Wwf, Gd^Wm, Rb^Gvs, Md, Rb^Gvs, Md^Xm, Md^Xm, Md, Hhd^Ftr, Gll^Ftr
Urb, Ql, Kud, Ql, Ql, Md^Xm, Md^Xm, Md^Xm, Md^Xm, Md, Md, Md, 3 Kh, Ch, 4 Kh, Hhd, Md, Md, Md^Xm, Md, Md^Xm, Md^Xm, Md, Md, Hhd, Hhd^Ftr, Gll^Ftr
Urb, Ql, Ql, Ql, Uu, Md^Xm, Md^Xm, Md^Xm, Md^Xm, Md^Xm, Md, Hhd, Rd, 2 Kh, Re, Hhd, Md, Md^Xm, Md^Xm, Md^Xm, Md^Xm, Md^Xm, Md, Md, Hhd^Ftr, Hhd^Ftr, Gll^Ftr
Uu, 1 Uu, Ql, Ql, Uu, Md^Xm, Md^Xm, Md^Xm, Md^Xm, Md, Hhd, Hhd^Vhh, Rd, Rd^Es, Rd, Gll^Ftr, Hhd, Md^Xm, Md^Xm, Md, Hhd^Ftr, Hhd, Hhd^Ftr, Hhd, Gll^Ftr, Hhd^Ftr, Gll^Ftr
Uu, Ql, Ql, Ql, Ql, Uu, Urb, Md, Md, Md, Hhd, Hhd, Rd, Rd, Rd, Gll^Ftr, Gll^Ftr, Hhd, Gll^Ftr, Hhd^Ftr, Gll^Ftr, Gll^Ftr, Gll^Ftr, Hhd^Ftr, Gll^Ftr, Gll^Ftr, Gll^Ftr
