border_size=1
usage=map

Xu, Xu, Xu, Xu, Xu, Xu, Uh^Br|, Xu, Xu, Xu, Uh^Br/, Uh^Br/, Xu, Xu, Xu, Xu, Xu, Xu, Xu, Xu, Xu, Xu, Xu, Xu, Xu, Xu, Xu, Xu, Xu, Xu, Xu, Xu, Xu, Xu, Xu, Xu, Xu
Xu, Xu, Xu, Xu, Xu, Xu, Uh^Br\, Xu, Ur^Br/, Ur^Br/, Xu, Xu, Xu, Xu, Xu, Xu, Xu, Xu, Xu, Xu, Xu, Xu, Ur^Em, Ur^Em, Ur^Em, Cud, Uu^Vu, Kud, Xu, Xu, Xu, Xu, Xu, Xu, Xu, Xu, Xu
Ww, Xu, Xu, Xu, Xu, Xu, Xu, Uh^Br|, Uu^Vud, Uh, Xu, Xu, Xu, Xu, Xu, Xu, Uu, Uh, Uu, Uu, Wwf, Ur^Em, Wwf, Wwf, Ur^Em, Cud, Cud, Cud, Wwf, Ur^Em, Uh^Em, Xu, Xu, Xu, Xu, Xu, Xu
Ww, Xu, Xu, Xu, Xu, Uh, Uh, Ur^Br|, Uu, Uh^Uf, Xu, Xu, Uh, Xu, Uu^Uf, Uu^Vud, Cud, 1 Kud, Cud, Cud, Uh, Xu, Uu^Uf, Ur^Em, Uu^Em, Uh^Em, Xu, Uu^Em, Wwf, Wwf, Wwf, Uu^Uf, Uh^Em, Xu, Xu, Xu, Xu
Ww, Ww, Xu, Xu, Xu, Xu, Cud, Ur, Xu, Xu, Xu, Uh, Uu^Vu, Uu^Uf, Wwf, Cud, Cud, Cud, Cud, Cud, Ur, Uh, Uu^Vu, Uu^Uf, Xu, Xu, Xu, Xu, Xu, Xu, Wwf, Ur^Em, Uh^Em, Xu, Xu, Xu, Xu
Wo, Ww, Ww, Xu, Hh, Gs, Rb, Xu, Xu, Xu, Xu, Uh, Wwf, Wwf, Ur, Uu, Cud, Rb, Rb, Ur, Uu, Ur, Uu^Uf, Ur, Cud, Xu, Xu, Xu, Xu, Xu, Xu, Wwf, Ur^Em, Uu^Uf, Xu, Xu, Xu
Gs, Ww, Wo, Ww, Ww, Gg, Rb, Gs^Fp, Hh, Xu, Wwf, Chw, Xu, Ur, Uu^Vud, Ur, Rb, Rb, Rb, Uu, Uu^Vud, Ur, Xu, Xu, Rd, Md, Hhd, Hhd, Hhd, Xu, Xu, Wwf, Ur, Uu^Vud, Xu, Xu, Xu
Gs, Wo, Wo, Ww, Ww, Chw, Chr, Rb, Rb, Wwf, Gg, Gll^Fdf, Xu, Xu, Xu, Xu, Cud, Rb, Cud, Xu, Xu, Xu, Xu, Xu, Rd, Hhd, Gll^Fdf, Hhd, Wwf, Xu, Wwf, Chw, Ur, Chr, Xu, Xu, Gd
Hh, Mm, Ww, Ww, Ww, Ww^Bw/r, Ww, Gs^Fp, Gg^Fet, Ww, Hh^Fmf, Gg, Gg^Vh, Xu, Xu, Xu, Rd, Cud, Rd, Xu, Xu, Xu, Rb, Hhd, Rd, Gd, Gll^Fdf, Gll, Wwf, Wwf, Wo, Wwf, Rb, Rb, Gd, Gd, Gd
Hh, Gg, Hh, Ww, Wo^Bw/r, Ww^Bw|r, Ww, Ww, Ww, Ww, Ww, Gg, Gll^Fdf, Hh, Hh, Hh^Fdf, Rd, Rd, Rd, Hd, Gd^Ft, Rb, Hhd, Rd, Gs^Vh, Gd^Fdf, Ww, Ww, Ww, Wo, Ww, Ww, Rb, Re, Gd, Gd^Vl, Gd
Hh^Fp, Hh, Gg, Chr, Gs^Fp, Wo, Wo, Ww, Wo, Ww, Ww, Chw, Gg, Gg, Gg, Gs, Rd, Rd, Rd, Rd, Rd, Rd, Rd, Rd, Gs, Hh, Ww, Ww, Wo, Ww, Gll^Fdf, Hhd^Fdf, Re, Re, Re, Re, Re
Hh^Fp, Hh, Gg, Rd, Gs, Gs^Fp, Xuc, Wo, Wo, Wo, Ww, Ww, Gs^Fdf, Gs, Gs^Vht, Gg, Rd, Rd, Rd, Dd^Do, Hhd, Gd^Ft, Md, Wwf, Wwf, Ww, Ww, Wo, Hhd, Ww, Gll^Fdf, Gll, Re, Re, Hhd^Fdf, Hhd^Fdf, Md
Hh^Fp, Gg, Gs^Fp, Rd, Gs^Vh, Gs^Fp, Uu^Em, Xuc, Wo, Wo, Ww, Ww, Wwf, Hh, Ww, Mm, Chw, Rd, Chw, Khw, Ww, Hhd, Wo, Ww, Ww, Ww, Wo, Wo, Hhd, Gll^Fdf, Gll, Gll^Vl, Re, Hhd, Hhd^Fdf, Hhd^Fdf, Md
Mm, Hh^Fp, Hh, Rd, Rd, Ur, Ur^Em, Xuc, Xuc, Ww, Ww, Wwf, Wo, Wo, Wo, Ww, Ww^Bw|, Ww^Bw|, Ww^Bw|, Ww, Wo, Wo, Wo, Wo, Wo, Ww, Md, Hhd, Gll^Fdf, Gll, Re, Re, Gll, Gll^Fdf, Hhd^Fdf, Md, Md
Mm^Xm, Mm, Mm, Hh, Gs^Fp, Rd, Uh, Ur^Em, Gs^Fmf, Gs^Fmf, Chr, Wwf, Ww, Wo, Wo, Ww, Ww^Bw|, Ww^Bw|, Ww^Bw|, Ww, Wo, Wo, Ww, Ww, Gll^Fdf, Gll, Gd, Gll, Rb, Re, Gll^Fdf, Gll^Fdf, Hhd, Hhd, Mv, Md, Mm
Mm^Xm, Mm^Xm, Mm^Xm, Mm, Hh, Rd, Rd, Rd, Rd, Gs^Fmf, Rd, Gg, Hh, Ss, Ss, Ww, Ww^Bw|, Ww^Bw|, Ww^Bw|, Wo, Gg, Ww, Wwf, Gll, Gll^Fdf, Gd, Chr, Rb, Hhd, Gll, Md^Xm, Md, Mm, Md, Md, Md^Xm, Md^Xm
Mm^Xm, Mm^Xm, Mm^Xm, Mm, Hh, Chr, Gg, Gg, Gs^Fmf, Rd, Rb^Gvs, Gg, Wwf, Ss, Hh, Mm, Rd, Rd, Rd, Gs^Fdf, Gs^Fdf, Gg, Hh, Wwf, Ww, Wwf, Wwf, Rb, Hhd, Md^Xm, Md^Xm, Md^Xm, Md^Xm, Md^Xm, Md^Xm, Md^Xm, Md^Xm
Mm, Mm^Xm, Mm, Mm, Mm, Rd, Gg, Gg^Wm, Rb^Gvs, Rb^Gvs, Rb^Gvs, Gg^Vh, Rd, Ww, Ww, Hh, Rd, Chr, Rd, Gg^Ve, Gs^Fdf, Hh, Rd, Rd, Rd, Rd, Rd, Wwf, Rd, Hhd, Mm, Md^Xm, Mm, Md^Xm, Hhd, Hhd, Rd
Hh^Fp, Mm, Mm, Mm, Gg, Rd, Hh, Hh, Rb^Gvs, Rb^Gvs, Rd, Rd, Gs^Fdf, Rd, Rd, Ww^Bw/, Wwf, Rd, Rd, Rd, Rd, Rd, Gs^Fdf, Gg, Gg^Wm, Gg, Gs^Vht, Rd, Gs, Rd, Rd, Rd, Rd, Rd, Rd, Rd, Dd
Rd, Hh^Fp, Gs^Fp, Gg, Rd, Rd, Rd, Hh, Rd, Rb^Gvs, Rd, Hh, Gg^Efm, Gg^Efm, Gg, Gll^Fdf, Wwf, Wwf, Ww, Rd, Wwf, Rd, Gg^Vh, Rb^Gvs, Rb^Gvs, Rb^Gvs, Rb^Gvs, Gs, Gs^Ft, Gll^Ft, Hd, Gd, Gd, Gd, Gd, Dd, Rd
Hh^Fmf, Rd, Rd, Rd, Gs, Gs, Gg, Rd, Gs^Fmf, Rd, Rd, Hh, Gg^Ve, Gg^Efm, Gs^Fmf, Ww, Gg^Ve, Gs^Fdf, Gg, Wwf, Rd, Wwf, Ww, Rb^Gvs, Rb^Gvs, Rb^Gvs, Gs, Gs, Gs^Ft, Gd, Dd, Dd, Dd, Gd^Ft, Dd, Dd, Dd
Hh^Fdf, Hh^Fmf, Gg, Gg, Gs, Gs, Gs, Gg, Gs^Fmf, Gs^Fmf, Rd, Gg, Gs^Fmf, Gs^Fmf, Gg^Fet, Ww, Gs^Fdf, Gs^Fdf, Gg, Rd, Rd, Rd, Gg, Ww, Wwf, Gg, Gs, Gs^Ft, Dd, Dd, Dd, Dd^Do, Dd, Gd^Ft, Dd, Dd^Esd, Dd
Hh^Fdf, Hh, Hh, Hh, Gs^Fdf, Gs, Gg^Vl, Gg, Ce, Ce, Ce, Gg, Wwf, Gg, Wwf, Ww, Gg, Gg, Ce, Rd, Rd, Rd, Rd, Gg, Chr, Chw, Chw, Hh, Gs^Ft, Dd^Edpp, Hd, Hd, Dd, Dd, Dd^Edpp, Dd, Dd
Gll^Fdf, Gs, Gs^Fdf, Gs^Fdf, Gg^Efm, Gg, Gg, Gg, Gg, 3 Ke, Ce, Wwf, Gg, Wwf, Re^Gvs, Ce, Ce, Gg^Ecf, Ce, Hh^Vhh, Rd, Rd, Rd, Chr, Gs^Ft, 4 Khr, Wwf, Gs, Gd^Ft, Dd, Dd^Esd, Dd, Hd, Dd, Dd, Dd, Dd
Gs^Fdf, Gll^Fdf, Gll^Fmf, Gg^Efm, Gs^Fdf, Gg, Hh^Fdf, Hh, Hh, Gg, Gg, Ww, Gg, Gs^Fdf, Re^Gvs, Gg^Vh, Re^Gvs, 2 Ke, Re^Gvs, Gg, Rd, Rd, Rd, Gs^Ft, Gs, Gs, Gs^Vht, Ww, Mm, Dd, Dd, Dd, Hhd, Dd, Hhd, Hhd, Hhd
Gll^Fmf, Gll^Fmf, Gll^Fmf, Gg^Efm, Gg^Efm, Gs^Fdf, Gg, Gg, Gg, Hh, Ww, Ww, Gg, Gs^Fmf, Gs^Fdf, Re^Gvs, Re^Gvs, Re^Gvs, Gg, Gg, Rd, Rd, Rd, Hh, Hh, Hh, Gs, Ww, Hh, Mm, Mm^Xm, Mm^Xm, Mm^Xm, Mm^Xm, Mm^Xm, Mm^Xm, Mm^Xm
Gs^Fp, Gll^Fp, Gll^Fp, Gll^Fmf, Gs^Fp, Gs^Fp, Gs^Fp, Gg, Gg, Gg, Ww, Gg, Gg, Gs^Fmf, Gg, Gg^Wm, Gg, Gg, Gg, Gg, Rd, Rd, Rd, Hh, Hh, Hh, Hh, Ww, Ww, Mm, Mm^Xm, Mm^Xm, Mm^Xm, Mm^Xm, Mm^Xm, Mm^Xm, Mm^Xm
