border_size=1
usage=map

Gll^Ftr, Ww, Gll^Ftr, Gll^Ftr, Gll^Ftr, Gs^Fp, Gll^Ftr, Gll^Ftr, Hh^Ftr, Hh^Ftr, Gll^Ftr, Hh^Ftr, Rb, Rb, Rb, Gll^Fp, Hhd, Gll^Fp, Ww, Gll^Fp, Hh, Gs^Ftp, Gs^Ftp, Gs^Fp, Gs^Ftp, Gd^Ftp, Gd^Ftp
Gll^Ftr, Ww, Ww, Gll^Efm, Gll^Ftr, Gll^Fet, Gll^Ftr, Hhd, Hhd, Gll^Ftr, Gll, Gll^Ftr, Rb, Rb, Rb, Rb, Rb, Ww, Gll^Fp, Gg^Efm, Gg^Efm, Gg^Efm, Gg^Fet, Gs^Ftp, Gd, Gd, Gd^Ftp
Hh^Ftr, Gll^Ftr, Gll^Ftr, Ww, Gll^Ftr, Gll^Efm, Gll^Efm, Hhd, Rb, Gll^Ve, Rb, Gll^Ftr, Rb, Ket, Rb, Hhd, Gd, Ww^Bw\, Re, Gg, Hh, Gs^Fp, Gg, Hhd, Gd, Hhd, Gd^Ftp
Hh^Ftr, Hhd, Gll, Wwf, Ww, Gll^Efm, Md, Rb, Gll^Fp, Rb, Gll, Ket, Rb, Rb, Rb, Ket, Gd^Vht, Ww, Ww, Re, Re, Hh, Gs, Hhd, Gd, Gd, Gd
Ww, Hhd, Gll^Ftr, Hhd, Ww^Vm, Ww, Ww^Bw/, Ww^Bw|, Ww, Hhd, Wwf, Hhd, Ww^Bw|, Ww^Bw|, Ww^Bw|, Gll^Fp, Ww, Hhd, Ww, Gs^Fp, Re, Gs^Fp, Gg^Ve, Gd, Gd^Ftd, Gd^Ftd, Hd
Wo, Ww, Ww, Ww, Wo, Ww, Ww^Bw|, Ww, Wo, Wo, Wo, Wwf, Ww, Ww^Bw|, Wo^Bw|, Ww, Ww, Ww, Ww, Gg^Fet, Wwf, Re, Md, Hhd, Hhd, Hd, Hd
Wo, Wo, Wo, Wo, Ww, Ww, Wo^Bw|, Ww, Ww, Wo, Wo, Wwf, Wo^Bw|, Wo^Bw|, Ww^Bw|, Wo, Wo, Ww, Wo, Wo, Wwf, Wwf, Ww, Hhd, Ww, Ds, Ds
Ww, Ww, Ww, Wo, Ww, Ww, Chw, Ww, Gs^Fp, Ww, Gs^Fp, Ww, Ww^Bw|, Ww^Bw|, Chw, Ww, Ww, Wo, Wo, Ww, Wwf, Wo, Wo, Ww, Wo, Ww^Vm, Ds
Ds, Ds, Ds, Ww, Gs^Fp, Mm, Rd, Gs^Vht, Rd, Hh, Gs^Fp, Chw, Chr, Rd, Khw, Chw, Gs^Fp, Hh, Gs^Fp, Ww, Chw, Wo, Ww, Wo, Ww, Ww, Ww
Ds, Ds, Hh^Vhh, Hh, Gs^Fp, Rd, Gs^Fp, Rd, Re^Gvs, Rd, Rd, Gs^Fp, Rd, Rd, Rd, Gg^Vc, Mm, Gs^Fp, Gs^Fp, Gg, Chr, Khw, Hh, Ww, Ww, Wo, Wo
Mm^Xm, Ds, Hh, Ch, Ch, Rd, Gs^Fp, Gg^Wm, Re^Gvs, Re^Gvs, Hh, Rd, Rd, Chr, Rd, Hh, Re^Gvs, Re^Gvs, Re^Gvs, Gg^Wm, Gs^Fp, Gg, Ss^Vhs, Ss, Ss, Ww, Wo
Mm^Xm, Mm^Xm, Mm^Xm, Mm^Xm, Kh, Rd, Ch, Mm^Xm, Mm, Re^Gvs, Hh, Gg^Vh, Rd, Rd, Rd, Re^Gvs, Re^Gvs, Re^Gvs, Gg^Vh, Re^Gvs, Gs^Fp, Ss, Ss, Ss, Ss, Ww, Ww
Mm^Xm, Mm^Xm, Mm^Xm, Mm^Xm, Hh, Rd, Gs^Fp, Mm^Xm, Mm^Xm, Mm^Xm, Mm^Xm, Gs^Fp, Ch, Rd, Ch, Mm^Xm, Mm^Xm, Mm^Xm, Mm^Xm, Mm^Xm, Mm^Xm, Wwf, Chs, Ss, Mm^Xm, Ss, Ss
Mm^Xm, Mm^Xm, Gs^Fp, Gs^Fp, Rd, Rd, Gg^Efm, Mm, Mm^Xm, Mm^Xm, Mm^Xm, Mm^Xm, Rd, Rd, Rd, Mm^Xm, Mm^Xm, Mm^Xm, Mm^Xm, Mm^Xm, Mm^Xm, Chw, Wwf, Mm^Xm, Mm^Xm, Mm^Xm, Mm^Xm
Mm^Xm, Mm^Xm, Hh, Gg^Vh, Rd, Gs^Fp, Hh, Ch, Gg^Vh, Mm^Xm, Hh, Hh, Rd, Gg^Fet, Rd, Gs^Fp, Gs^Fp, Mm^Xm, Gs^Fp, Mm^Xm, Gg^Vh, Wwf, Rb, Hh, Mm^Xm, Mm^Xm, Mm^Xm
Mm^Xm, Mm^Xm, Hh, Gs, Gs^Fp, Rd, Rd, Gg^Efm, Rd, Gs^Fp, Gs^Fp, Hh, Rd, Rd, Ch, Hh, Gg^Vh, Hh, Ww^Bw/, Rb, Rb, Ww^Bw/, Gs^Fp, Hh, Mm^Xm, Mm^Xm, Mm^Xm
Mm^Xm, Mm^Xm, Mm^Xm, Gs^Fp, Hh, Ch, Hh, Rd, Gg, Rd, Rd, Gs^Vl, Rd, Ch, Kh, Gg, Re, Re, Wwf, Ww, Wwf, Wwf, Gg, Gs^Fp, Mm^Xm, Mm^Xm, Mm^Xm
Mm^Xm, Mm^Xm, Mm^Xm, Gs^Fp, Gs^Fp, Gs, Gs, Gs^Fp, Hh, Ch, Gg, Rd, Rd, Rd, Rd, Re, Hh, Gs^Fp, Wwf, Wwf, Hh^Vhh, Ww, Hh, Gs^Fp, Mm^Xm, Mm^Xm, Mm^Xm
Mm^Xm, Mm^Xm, Mm^Xm, Mm^Xm, Mm, Gs^Fp, Mm, Hh, Gs, Gg^Fet, Gs^Fp, Hh, Rd, Rd, Rd, Gg^Efm, Ww, Wwf, Wwf, Ww, Re^Gvs, Mm, Mm^Xm, Mm^Xm, Mm^Xm, Mm^Xm, Mm^Xm
Mm^Xm, Mm^Xm, Mm^Xm, Mm^Xm, Mm^Xm, Mm^Xm, Mm^Xm, Mm, Mm, Gs^Fp, Ch, Gg, Ch, Ch, Ch, Gg^Efm, Ch, Wwf, Gs^Fp, Re^Gvs, Re^Gvs, Hh, Mm^Xm, Mm^Xm, Mm^Xm, Mm^Xm, Mm^Xm
Ql, Ql, Ql, Mm^Xm, Ql, Mm^Xm, Mm^Xm, Mm^Xm, Mm^Xm, Hh, Hh^Vhh, Ch, Ch, Ch, Ch, Ch, Hh^Vhh, Gs^Fp, Gg^Wm, Re^Gvs, Mm, Re^Gvs, Mm^Xm, Mm^Xm, Mm^Xm, Mm^Xm, Mm^Xm
Uu, Ql, Kud, Ql, Ql, Mm^Xm, Mm^Xm, Mm^Xm, Mm^Xm, Mm, Mm, Mm, 3 Kh, Ch, 4 Kh, Hh, Mm, Mm, Mm^Xm, Mm, Mm^Xm, Mm^Xm, Mm^Xm, Mm^Xm, Hh, Mm^Xm, Mm^Xm
Uu, Ql, Ql, Ql, Uu, Mm^Xm, Mm^Xm, Mm^Xm, Mm^Xm, Mm^Xm, Mm, Hh, Rd, 2 Kh, Rd, Hh, Mm, Mm^Xm, Mm^Xm, Mm^Xm, Mm^Xm, Mm^Xm, Mm^Xm, Mm^Xm, Mm^Xm, Mm^Xm, Mm^Xm
Uu, 1 Uu, Ql, Ql, Uu, Mm^Xm, Mm^Xm, Mm^Xm, Mm^Xm, Mm, Hh, Hh^Vhh, Rd, Rd, Rd, Gs^Fp, Hh, Mm^Xm, Mm^Xm, Mm^Xm, Mm^Xm, Mm^Xm, Mm^Xm, Mm^Xm, Mm^Xm, Mm^Xm, Mm^Xm
Uu, Ql, Ql, Ql, Ql, Uu, Mm^Xm, Mm^Xm, Mm^Xm, Mm, Hh, Hh, Rd, Rd, Rd, Gs^Fp, Gs^Fp, Mm^Xm, Mm^Xm, Mm^Xm, Mm^Xm, Mm^Xm, Mm^Xm, Mm^Xm, Mm^Xm, Mm^Xm, Mm^Xm
