border_size=1
usage=map

Xu, Xu, Xu, Xu, Xu, Xu, Uh^Br|, Xu, Xu, Xu, Uh^Br/, Uh^Br/, Xu, Xu, Xu, Xu, Xu, Xu, Xu, Xu, Xu, Xu, Xu, Xu, Xu, Xu, Xu, Xu, Xu, Xu, Xu, Xu, Xu, Xu, Xu, Xu, Xu
Xu, Xu, Xu, Xu, Xu, Xu, Uh^Br\, Xu, Ur^Br/, Ur^Br/, Xu, Xu, Xu, Xu, Xu, Xu, Xu, Xu, Xu, Xu, Xu, Xu, Ur^Em, Ur^Em, Ur^Em, Cud, Uu^Vu, Kud, Xu, Xu, Xu, Xu, Xu, Xu, Xu, Xu, Xu
Wo, Xu, Xu, Xu, Xu, Xu, Xu, Uh^Br|, Uu^Vud, Uh, Xu, Xu, Xu, Xu, Xu, Xu, Uu, Uh, Uu^Em, Uu, Wwf, Ur^Em, Wwf, Wwf, Ur^Em, Cud, Cud, Cud, Wwf, Ur^Em, Uh^Em, Xu, Xu, Xu, Xu, Xu, Xu
Wo, Wo, Xu, Xu, Xu, Uh, Uh, Ur^Br|, Ur^Em, Uh^Uf, Xu, Xu, Uh, Xu, Uu^Uf, Uu^Vud, Cud, 1 Kud, Cud, Cud, Rb, Xu, Uu^Uf, Ur^Em, Rb, Uh^Em, Xu, Uu^Em, Wwf, Wwf, Wwf, Uu^Uf, Uh^Em, Xu, Xu, Xu, Xu
Wo, Wo, Wo, Xu, Xu, Xu, Cud, Ur^Br/, Xu, Xu, Xu, Uh, Uu^Vu, Uu^Uf, Wwf, Cud, Cud, Cud, Cud, Cud, Ur, Uh, Uu^Vu, Uu^Uf, Xu, Xu, Xu, Xu, Xu, Xu, Wwf, Ur^Em, Uh^Em, Xu, Xu, Xu, Xu
Wo, Wo, Wo, Xu, Hh, Gs, Rb, Xu, Xu, Xu, Xu, Uh, Wwf, Wwf, Ur, Uu^Em, Cud, Rb, Rb, Ur, Uu^Em, Ur, Uu^Uf, Ur^Em, Cud, Xu, Xu, Xu, Xu, Xu, Xu, Wwf, Ur^Em, Uu^Uf, Xu, Xu, Xu
Hh, Wo, Wo, Ww, Wwf, Gg, Rb, Gs^Fp, Hh, Xu, Wwf, Chw, Xu, Ur^Em, Uu^Vud, Ur, Rb, Rb, Rb, Uu, Uu^Vud, Ur, Xu, Xu, Rd, Md, Hhd, Hhd, Hhd, Xu, Xu, Wwf, Ur, Uu^Vud, Xu, Xu, Xu
Hh, Wo, Wo, Ww, Wwf, Chw, Chr, Rb, Rb, Wwf, Gg, Gll^Fdf, Xu, Xu, Xu, Xu, Cud, Rb, Cud, Xu, Xu, Xu, Xu, Xu, Rd, Hhd, Gll^Fdf, Hhd, Wwf, Xu, Wwf, Chw, Ur, Chr, Xu, Xu, Gd^Fdf
Hh, Mm, Ww, Ww, Ww, Wwf^Bw/r, Wwg, Gs^Fp, Gg^Fet, Wwf, Hh^Fmf, Gg, Gg^Vh, Xu, Xu, Xu, Re, Cud, Rd, Xu, Xu, Xu, Rb, Hhd, Rd, Gd, Gll, Gll, Wwf, Wwf, Wwg, Wwf, Rb, Rb, Gd, Gd, Gd^Fdf
Hh, Gg, Hh, Ww, Wo^Bw/r, Ww^Bw|r, Ww, Wwg, Ww, Wwg, Wwg, Gg, Gll^Fdf, Hh, Hh, Hh^Fdf, Re^Es, Re, Rd, Hhd, Gd^Ft, Rb, Hhd, Rd, Gd^Vh, Gd^Fdf, Wwg, Wwg, Wwg, Wwg, Wwg, Wwg, Rb, Re, Gd^Efm, Gd^Vh, Gd
Hh^Fp, Gg, Gg, Chr, Gs^Fp, Wo, Wo, Ww, Wo, Ww, Ww, Chw, Gg, Gg, Gg, Gs, Re, Rd, Rd^Es, Rd, Rd, Rd, Rd, Rd, Ce, Hhd, Ww, Ww, Ww, Ww, Gll^Fdf, Hhd^Fdf, Re, Re, Re, Re, Re
Hh^Fp, Hh, Gg, Rd, Gs^Efm, Gs, Xuc, Wo, Wo, Wo, Ww, Ww, Gs^Fdf, Gs, Gs^Vht, Gg, Re, Rd^Es, Chr, Rd^Do, Hhd, Gd^Ft, Md, Wwf, Wwf, Wwg, Ww, Ww, Hhd^Fdf, Ww, Gll^Fdf, Gll^Em, Re, Re, Hhd^Fdf, Hhd^Fdf, Hhd^Fdf
Hh^Fp, Gg, Gs^Fp, Rd, Gs^Vh, Gs^Fp, Uu^Em, Xuc, Wo, Wo, Ww, Ww, Wwf, Hh, Ww, Mm, Chw, Re, Chw, Khw, Ww, Hhd, Wo, Wwg, Wwf, Wwg, Wwg, Ww, Hhd, Gll, Gll, Gll^Vl, Re, Hhd, Hhd^Fdf, Hhd, Hhd^Fdf
Mm, Hh^Fp, Hh, Rd, Rd, Ur, Ur^Em, Xuc, Xuc, Ww, Ww, Wwf, Ww, Ww, Ww, Ww, Ww^Bw|, Ww^Bw|, Ww^Bw|, Ww, Wo, Wo, Wo, Wwg, Wwg, Wwf, Md, Hhd, Gll^Fdf, Gll, Re, Re, Gll, Gll^Fdf, Hhd^Fdf, Md, Hhd^Fdf
Mm^Xm, Mm, Mm, Gs, Gs^Fp, Rd^Es, Uh, Ur^Em, Hhd^Fmf, Gll^Fmf, Chr, Wwf, Ww, Wo, Wo, Ww, Ww^Bw|, Ww^Bw|, Ww^Bw|, Ww, Wo, Wo, Wwg, Wwg, Gll^Fdf, Gll, Gd, Gll, Rb, Re, Gll^Fdf, Gll^Fdf, Hhd, Hhd, Mv, Md, Mm
Mm^Xm, Mm^Xm, Mm^Xm, Hh, Gs, Rd, Rd, Rd, Rd, Gll^Fmf, Rd, Gg, Hh, Ss, Ss, Ww, Ww^Bw|, Ww^Bw|, Ww^Bw|, Ww, Gs, Wwg, Wwf, Gll, Gll^Fdf, Gd, Chr, Rb, Hhd, Gll, Md^Xm, Md, Mm, Md, Md, Md^Xm, Md^Xm
Mm^Xm, Mm^Xm, Mm^Xm, Mm^Xm, Hh, Chr, Gs, Gg, Gs^Fmf, Rd, Rb^Gvs, Gg, Wwf, Ss, Hh, Mm, Re, Re, Re, Gs^Fdf, Gll^Fdf, Gg, Hh, Wwf, Wwf, Wwf, Wwf, Rb, Hhd, Md^Xm, Md^Xm, Md^Xm, Md^Xm, Md^Xm, Md^Xm, Md^Xm, Md^Xm
Mm, Mm^Xm, Mm, Mm, Gs, Rd, Gg, Gg^Wm, Rb^Gvs, Rb^Gvs, Rb^Gvs, Gg^Vh, Re, Wwg, Wwg, Hh, Re, Chr, Re, Gs^Ve, Gs^Fdf, Hh, Re, Re, Re, Re, Re, Wwf, Re, Hhd, Mm, Md^Xm, Mm, Md^Xm, Hhd, Hhd, Rd
Hh^Fp, Mm, Mm, Hh, Gs, Rd, Hh, Hh, Rb^Gvs, Rb^Gvs, Rd, Rd, Gll^Fdf, Re, Re, Wwg^Bw/, Wwf, Re, Re^Es, Re, Re, Re, Gs^Fdf, Gg, Gg^Wm, Gg, Gs^Vht, Re, Gs, Rd, Rd, Rd, Rd, Rd, Rd, Rd, Dd
Rd, Hh^Fp, Gs^Fp, Gs, Rd, Rd, Rd, Hh, Rd, Rb^Gvs, Rd, Hh, Gg^Efm, Gg^Efm, Gg, Gll^Fdf, Wwf, Wwf, Wwf, Re, Wwf, Re, Gg^Vh, Rb^Gvs, Rb^Gvs, Rb^Gvs, Rb^Gvs, Gs, Gs^Ft, Gll^Ft, Hd, Gd, Gd, Gd, Gd, Dd, Rd
Hh^Fmf, Rd, Rd, Rd, Gs, Gs, Rb^Gvs, Rd, Gd^Fmf, Rd^Es, Rd, Hh, Gg^Ve, Gg^Efm, Gs^Fmf, Wwf, Gs^Ve, Gll^Fdf, Gg, Wwf, Re, Wwf, Wwf, Rb^Gvs, Rb^Gvs, Rb^Gvs, Gs, Gs, Gd^Ft, Gd, Dd, Dd, Dd, Gd^Ft, Dd, Dd, Dd
Hh^Fdf, Hh^Fmf, Gg, Gg, Gs, Rb^Gvs, Rb^Gvs, Rb^Gvs, Gd^Fmf, Gd^Fmf, Rd, Gg, Gs^Fmf, Gg, Gg^Fet, Wwf, Gd^Fdf, Gll^Fdf, Gg, Re, Re, Re, Gg, Wwf, Wwf, Gg, Gs, Gs^Ft, Dd, Dd, Dd, Dd^Do, Dd, Gd^Ft, Dd, Dd^Esd, Dd
Hh^Fdf, Hh, Hh, Hh, Gd^Fdf, Rb^Gvs, Gg^Vl, Gg, Ce, Ce, Ce, Gg, Wwf, Gg, Wwf, Wwf, Gg, Gg, Ce, Re, Re, Re, Rd, Gg, Chr, Chw, Chw, Hhd, Gd^Ft, Dd^Edpp, Hd, Hd, Dd, Dd, Dd^Edpp, Dd, Dd
Gll^Fdf, Gs, Gs^Fdf, Gd^Fdf, Gg^Efm, Gg, Gg, Gg, Gg, 3 Ket, Ce, Wwf, Gg, Wwf, Rb^Gvs, Ce, Ce, Gg^Ecf, Ce, Hh^Vhh, Re, Rd, Rd, Chr, Gs^Ft, 4 Khr, Wwf, Gd, Gd, Dd, Dd^Esd, Dd, Hd, Dd, Dd, Dd, Dd
Gs^Fdf, Gll^Fdf, Gll^Fmf, Gg^Efm, Gd^Fdf, Gg, Hh^Fdf, Hh, Hh, Gg, Gg, Wwf, Gg, Gd^Fdf, Rb^Gvs, Gg^Vh, Rb^Gvs, 2 Ke, Rb^Gvs, Gg, Re, Rd^Es, Rd, Gs^Ft, Gs, Gs, Gs^Vhc, Wwf, Md, Dd, Dd, Dd, Hhd, Dd, Hhd, Hhd, Hhd
Gll^Fmf, Gll^Fmf, Gll^Fmf, Gg^Efm, Gg^Efm, Gd^Fdf, Gg, Gg, Gg, Hh, Wwf, Wwf, Gg, Gd^Fmf, Gd^Fdf, Rb^Gvs, Rb^Gvs, Rb^Gvs, Gg, Gg, Rd, Rd, Rd, Hh, Hh, Hh, Gs, Wwf, Hhd, Md, Md^Xm, Md, Md^Xm, Md^Xm, Md^Xm, Md, Md
Gs^Fp, Gll^Fp, Gll^Fp, Gll^Fmf, Gs^Fp, Gs^Fp, Gs^Fp, Gg, Gg, Gg, Wwf, Gg, Gg, Gs^Fmf, Gg, Gg^Wm, Gg, Gg, Gg, Gg, Rd, Rd, Rd, Hh, Hh, Hh, Hh, Wwf, Wwf, Md, Md, Md, Md, Md^Xm, Md, Md, Md
