border_size=1
usage=map

Gs^Fp       , Ww          , Gs^Fp       , Gs^Fp       , Gs^Fp       , Gs^Fp       , Gs^Fp       , Gs^Fp       , Hh          , Hh          , Gs^Fp       , Hh          , Re          , Re          , Re          , Gs^Fp       , Hh          , Gs^Fp       , Ww          , Gs^Fp       , Hh          , Gs^Fp       , Gs^Fp       , Gs^Fp       , Gs^Fp       , Gs^Fp       , Gs^Fp       
Gs^Fp       , Ww          , Ww          , Ggf         , Gs^Fp       , Gg^Fet      , Gs^Fp       , Hh          , Hh          , Gs^Fp       , Gg          , Gs^Fp       , Re          , Re          , Re          , Re          , Re          , Ww          , Gs^Fp       , Ggf         , Ggf         , Ggf         , Gg^Fet      , Gs^Fp       , Gs          , Gs          , Gs^Fp       
Hh          , Gs^Fp       , Gs^Fp       , Ww          , Gs^Fp       , Ggf         , Ggf         , Hh          , Re          , Gg^Ve       , Re          , Gs^Fp       , Re          , Ce          , Re          , Hh          , Gs          , Ww^Bw\      , Re          , Gg          , Hh          , Gs^Fp       , Gg          , Hh          , Gg          , Hh          , Gs^Fp       
Hh          , Hh          , Gg          , Wwf         , Ww          , Ggf         , Mm          , Re          , Gs^Fp       , Re          , Gg          , Ce          , Re          , Re          , Re          , Ce          , Gs^Vht      , Ww          , Ww          , Re          , Re          , Hh          , Gs          , Hh          , Gg          , Gs          , Gs          
Ww          , Hh          , Gg^Fet      , Hh          , Ww^Vm       , Ww          , Ww^Bw/      , Ww^Bw|      , Ww          , Hh          , Wwf         , Hh          , Ww^Bw|      , Ww^Bw|      , Ww^Bw|      , Gs^Fp       , Ww          , Hh          , Ww          , Gs^Fp       , Re          , Gs^Fp       , Gg^Ve       , Gs          , Gs^Fp       , Gs^Fp       , Hd          
Wo          , Ww          , Ww          , Ww          , Wo          , Ww          , Ww^Bw|      , Ww          , Wo          , Wo          , Wo          , Wwf         , Ww          , Ww^Bw|      , Wo^Bw|      , Ww          , Ww          , Ww          , Ww          , Gg^Fet      , Wwf         , Re          , Mm          , Hh          , Hh          , Hd          , Hd          
Wo          , Wo          , Wo          , Wo          , Ww          , Ww          , Wo^Bw|      , Ww          , Ww          , Wo          , Wo          , Wwf         , Wo^Bw|      , Wo^Bw|      , Ww^Bw|      , Wo          , Wo          , Ww          , Wo          , Wo          , Wwf         , Wwf         , Ww          , Hh          , Ww          , Ds          , Ds          
Ww          , Ww          , Ww          , Wo          , Ww          , Ww          , Chw         , Ww          , Gs^Fp       , Ww          , Gs^Fp       , Ww          , Ww^Bw|      , Ww^Bw|      , Chw         , Ww          , Ww          , Wo          , Wo          , Ww          , Wwf         , Wo          , Wo          , Ww          , Wo          , Ww^Vm       , Ds          
Ds          , Ds          , Ds          , Ww          , Gs^Fp       , Mm          , Rd          , Gs^Vht      , Rd          , Hh          , Gs^Fp       , Chw         , Chr         , Rd          , Khw         , Chw         , Gs^Fp       , Hh          , Gs^Fp       , Ww          , Chw         , Wo          , Ww          , Wo          , Ww          , Ww          , Ww          
Ds          , Ds          , Hh^Vhh      , Hh          , Gs^Fp       , Rd          , Gs^Fp       , Rd          , Re^Gvs      , Rd          , Rd          , Gs^Fp       , Rd          , Rd          , Rd          , Gg^Vc       , Mm          , Gs^Fp       , Gs^Fp       , Gg          , Chr         , Khw         , Hh          , Ww          , Ww          , Wo          , Wo          
Mm^Xm       , Ds          , Hh          , Ch          , Ch          , Rd          , Gs^Fp       , Gg^Wm       , Re^Gvs      , Re^Gvs      , Hh          , Rd          , Rd          , Chr         , Rd          , Hh          , Re^Gvs      , Re^Gvs      , Re^Gvs      , Gg^Wm       , Gs^Fp       , Gg          , Ss^Vhs      , Ss          , Ss          , Ww          , Wo          
Mm^Xm       , Mm^Xm       , Mm^Xm       , Mm^Xm       , Kh          , Rd          , Ch          , Mm^Xm       , Mm          , Re^Gvs      , Hh          , Gg^Vh       , Rd          , Rd          , Rd          , Re^Gvs      , Re^Gvs      , Re^Gvs      , Gg^Vh       , Re^Gvs      , Gs^Fp       , Ss          , Ss          , Ss          , Ss          , Ww          , Ww          
Mm^Xm       , Mm^Xm       , Mm^Xm       , Mm^Xm       , Hh          , Rd          , Gs^Fp       , Mm^Xm       , Mm^Xm       , Mm^Xm       , Mm^Xm       , Gs^Fp       , Ch          , Rd          , Ch          , Mm^Xm       , Mm^Xm       , Mm^Xm       , Mm^Xm       , Mm^Xm       , Mm^Xm       , Wwf         , Chs         , Ss          , Mm^Xm       , Ss          , Ss          
Mm^Xm       , Mm^Xm       , Gs^Fp       , Gs^Fp       , Rd          , Rd          , Ggf         , Mm          , Mm^Xm       , Mm^Xm       , Mm^Xm       , Mm^Xm       , Rd          , Rd          , Rd          , Mm^Xm       , Mm^Xm       , Mm^Xm       , Mm^Xm       , Mm^Xm       , Mm^Xm       , Chw         , Wwf         , Mm^Xm       , Mm^Xm       , Mm^Xm       , Mm^Xm       
Mm^Xm       , Mm^Xm       , Hh          , Gg^Vh       , Rd          , Gs^Fp       , Hh          , Ch          , Gg^Vh       , Mm^Xm       , Hh          , Hh          , Rd          , Gg^Fet      , Rd          , Gs^Fp       , Gs^Fp       , Mm^Xm       , Gs^Fp       , Mm^Xm       , Gg^Vh       , Wwf         , Rd          , Hh          , Mm^Xm       , Mm^Xm       , Mm^Xm       
Mm^Xm       , Mm^Xm       , Hh          , Gs          , Gs^Fp       , Rd          , Rd          , Ggf         , Rd          , Gs^Fp       , Gs^Fp       , Hh          , Rd          , Rd          , Ch          , Hh          , Gg^Vh       , Hh          , Ww^Bw/      , Rd          , Rd          , Ww^Bw/      , Gs^Fp       , Hh          , Mm^Xm       , Mm^Xm       , Mm^Xm       
Mm^Xm       , Mm^Xm       , Mm^Xm       , Gs^Fp       , Hh          , Ch          , Hh          , Rd          , Gg          , Rd          , Rd          , Gg^Vh       , Rd          , Ch          , Kh          , Gg          , Rd          , Rd          , Wwf         , Ww          , Wwf         , Wwf         , Gg          , Gs^Fp       , Mm^Xm       , Mm^Xm       , Mm^Xm       
Mm^Xm       , Mm^Xm       , Mm^Xm       , Gs^Fp       , Gs^Fp       , Gs          , Gs          , Gs^Fp       , Hh          , Ch          , Gg          , Rd          , Rd          , Rd          , Rd          , Rd          , Hh          , Gs^Fp       , Wwf         , Wwf         , Hh^Vhh      , Ww          , Hh          , Gs^Fp       , Mm^Xm       , Mm^Xm       , Mm^Xm       
Mm^Xm       , Mm^Xm       , Mm^Xm       , Mm^Xm       , Mm          , Gs^Fp       , Mm          , Hh          , Gs          , Gg^Fet      , Gs^Fp       , Hh          , Rd          , Rd          , Rd          , Ggf         , Ww          , Wwf         , Wwf         , Ww          , Re^Gvs      , Mm          , Mm^Xm       , Mm^Xm       , Mm^Xm       , Mm^Xm       , Mm^Xm       
Mm^Xm       , Mm^Xm       , Mm^Xm       , Mm^Xm       , Mm^Xm       , Mm^Xm       , Mm^Xm       , Mm          , Mm          , Gs^Fp       , Ch          , Gg          , Ch          , Ch          , Ch          , Ggf         , Ch          , Wwf         , Gs^Fp       , Re^Gvs      , Re^Gvs      , Hh          , Mm^Xm       , Mm^Xm       , Mm^Xm       , Mm^Xm       , Mm^Xm       
Ql          , Ql          , Ql          , Mm^Xm       , Ql          , Mm^Xm       , Mm^Xm       , Mm^Xm       , Mm^Xm       , Hh          , Hh^Vhh      , Ch          , Ch          , Ch          , Ch          , Ch          , Hh^Vhh      , Gs^Fp       , Gg^Wm       , Re^Gvs      , Mm          , Re^Gvs      , Mm^Xm       , Mm^Xm       , Mm^Xm       , Mm^Xm       , Mm^Xm       
Uu          , Ql          , Kud         , Ql          , Ql          , Mm^Xm       , Mm^Xm       , Mm^Xm       , Mm^Xm       , Mm          , Mm          , Mm          , 3 Kh        , Ch          , 4 Kh        , Hh          , Mm          , Mm          , Mm^Xm       , Mm          , Mm^Xm       , Mm^Xm       , Mm^Xm       , Mm^Xm       , Hh          , Mm^Xm       , Mm^Xm       
Uu          , Ql          , Ql          , Ql          , Uu          , Mm^Xm       , Mm^Xm       , Mm^Xm       , Mm^Xm       , Mm^Xm       , Mm          , Hh          , Rd          , 2 Kh        , Rd          , Hh          , Mm          , Mm^Xm       , Mm^Xm       , Mm^Xm       , Mm^Xm       , Mm^Xm       , Mm^Xm       , Mm^Xm       , Mm^Xm       , Mm^Xm       , Mm^Xm       
Uu          , 1 Uu        , Ql          , Ql          , Uu          , Mm^Xm       , Mm^Xm       , Mm^Xm       , Mm^Xm       , Mm          , Hh          , Hh^Vhh      , Rd          , Rd          , Rd          , Gs^Fp       , Hh          , Mm^Xm       , Mm^Xm       , Mm^Xm       , Mm^Xm       , Mm^Xm       , Mm^Xm       , Mm^Xm       , Mm^Xm       , Mm^Xm       , Mm^Xm       
Uu          , Ql          , Ql          , Ql          , Ql          , Uu          , Mm^Xm       , Mm^Xm       , Mm^Xm       , Mm          , Hh          , Hh          , Rd          , Rd          , Rd          , Gs^Fp       , Gs^Fp       , Mm^Xm       , Mm^Xm       , Mm^Xm       , Mm^Xm       , Mm^Xm       , Mm^Xm       , Mm^Xm       , Mm^Xm       , Mm^Xm       , Mm^Xm       
