border_size=1
usage=map

Qxua^Xo, Qxua^Xo, Qxua^Xo, Qxua^Xo, Qxua^Xo, Qxua^Xo, Qxua^Xo, Qxua^Xo, Qxua^Xo, Qxua^Xo, Qxua^Xo, Qxua^Xo, Qxua^Xo, Qxua^Xo, Qxua^Xo, Qxua^Xo, Qxua^Xo, Qxua^Xo, Qxua^Xo, Qxua^Xo, Qxua^Xo, Qxua^Xo, Qxua^Xo, Qxua^Xo, Qxua^Xo, Qxua^Xo, Qxua^Xo, Qxua^Xo, Qxua^Xo, Qxua^Xo, Qxua^Xo, Qxua^Xo, Qxua^Xo, Qxua^Xo, Qxua^Xo, Qxua^Xo, Qxua^Xo, Qxua^Xo, Qxua^Xo, Qxua^Xo, Qxua^Xo, Qxua^Xo, Qxua^Xo, Qxua^Xo, Qxua^Xo, Qxua^Xo, Qxua^Xo, Qxua^Xo, Qxua^Xo, Qxua^Xo, Qxua^Xo, Qxua^Xo, Qxua^Xo
Qxua^Xo, Qxua^Xo, Qxua^Xo, Qxua^Xo, Qxua^Xo, Qxua^Xo, Qxua^Xo, Qxua^Xo, Qxua^Xo, Qxua^Xo, Qxua^Xo, Qxua^Xo, Qxua^Xo, Qxua^Xo, Qxua^Xo, Qxua^Xo, Qxua^Xo, Qxua^Xo, Qxua^Xo, Qxua^Xo, Qxua^Xo, Qxua^Xo, Qxua^Xo, Qxua^Xo, Qxua^Xo, Qxua^Xo, Qxua^Xo, Qxua^Xo, Qxua^Xo, Qxua^Xo, Qxua^Xo, Qxua^Xo, Qxua^Xo, Qxua^Xo, Qxua^Xo, Qxua^Xo, Qxua^Xo, Qxua^Xo, Qxua^Xo, Qxua^Xo, Qxua^Xo, Qxua^Xo, Qxua^Xo, Qxua^Xo, Qxua^Xo, Qxua^Xo, Qxua^Xo, Qxua^Xo, Qxua^Xo, Qxua^Xo, Qxua^Xo, Qxua^Xo, Qxua^Xo
Qxua^Xo, Qxua^Xo, Qxua^Xo, Qxua^Xo, Qxua^Xo, Qxua^Xo, Qxua^Xo, Qxua^Xo, Qxua^Xo, Qxua^Xo, Qxua^Xo, Qxua^Xo, Qxua^Xo, Qxua^Xo, Qxua^Xo, Qxua^Xo, Qxua^Xo, Qxua^Xo, Qxua^Xo, Qxua^Xo, Qxua^Xo, Qxua^Xo, Qxua^Xo, Qxua^Xo, Qxua^Xo, Qxua^Xo, Qxua^Xo, Qxua^Xo, Qxua^Xo, Qxua^Xo, Qxua^Xo, Qxua^Xo, Qxua^Xo, Qxua^Xo, Qxua^Xo, Qxua^Xo, Qxua^Xo, Qxua^Xo, Qxua^Xo, Qxua^Xo, Qxua^Xo, Qxua^Xo, Qxua^Xo, Qxua^Xo, Qxua^Xo, Qxua^Xo, Qxua^Xo, Qxua^Xo, Qxua^Xo, Qxua^Xo, Qxua^Xo, Qxua^Xo, Qxua^Xo
Qxua^Xo, Qxua^Xo, Qxua^Xo, Qxua^Xo, Qxua^Xo, Qxua^Xo, Qxua^Xo, Qxua^Xo, Qxua^Xo, Qxua^Xo, Qxua^Xo, Qxua^Xo, Qxua^Xo, Qxua^Xo, Qxua^Xo, Qxua^Xo, Qxua^Xo, Qxua^Xo, Qxua^Xo, Qxua^Xo, Qxua^Xo, Qxua^Xo, Qxua^Xo, Qxua^Xo, Qxua^Xo, Qxua^Xo, Qxua^Xo, Qxua^Xo, Qxua^Xo, Qxua^Xo, Qxua^Xo, Qxua^Xo, Qxua^Xo, Qxua^Xo, Qxua^Xo, Qxua^Xo, Qxua^Xo, Qxua^Xo, Qxua^Xo, Qxua^Xo, Qxua^Xo, Qxua^Xo, Qxua^Xo, Qxua^Xo, Qxua^Xo, Qxua^Xo, Qxua^Xo, Qxua^Xo, Qxua^Xo, Qxua^Xo, Qxua^Xo, Qxua^Xo, Qxua^Xo
Qxua^Xo, Qxua^Xo, Qxua^Xo, Qxua^Xo, Qxua^Xo, Qxua^Xo, Qxua^Xo, Qxua^Xo, Qxua^Xo, Qxua^Xo, Qxua^Xo, Qxua^Xo, Qxua^Xo, Qxua^Xo, Qxua^Xo, Qxua^Xo, Qxua^Xo, Qxua^Xo, Qxua^Xo, Qxua^Xo, Qxua^Xo, Qxua^Xo, Qxua^Xo, Qxua^Xo, Qxua^Xo, Qxua^Xo, Qxua^Xo, Qxua^Xo, Qxua^Xo, Qxua^Xo, Qxua^Xo, Qxua^Xo, Qxua^Xo, Qxua^Xo, Qxua^Xo, Qxua^Xo, Qxua^Xo, Qxua^Xo, Qxua^Xo, Qxua^Xo, Qxua^Xo, Qxua^Xo, Qxua^Xo, Qxua^Xo, Qxua^Xo, Qxua^Xo, Qxua^Xo, Qxua^Xo, Qxua^Xo, Qxua^Xo, Qxua^Xo, Qxua^Xo, Qxua^Xo
Qxua^Xo, Qxua^Xo, Qxua^Xo, Qxua^Xo, Qxua^Xo, Qxua^Xo, Qxua^Xo, Qxua^Xo, Qxua^Xo, Qxua^Xo, Qxua^Xo, Qxua^Xo, Qxua^Xo, Qxua^Xo, Qxua^Xo, Qxua^Xo, Qxua^Xo, Qxua^Xo, Qxua^Xo, Qxua^Xo, Qxua^Xo, Qxua^Xo, Qxua^Xo, Qxua^Xo, Qxua^Xo, Qxua^Xo, Qxua^Xo, Qxua^Xo, Qxua^Xo, Qxua^Xo, Qxua^Xo, Qxua^Xo, Qxua^Xo, Qxua^Xo, Qxua^Xo, Qxua^Xo, Qxua^Xo, Qxua^Xo, Qxua^Xo, Qxua^Xo, Qxua^Xo, Qxua^Xo, Qxua^Xo, Qxua^Xo, Qxua^Xo, Qxua^Xo, Qxua^Xo, Qxua^Xo, Qxua^Xo, Qxua^Xo, Qxua^Xo, Qxua^Xo, Qxua^Xo
Qxua^Xo, Qxua^Xo, Qxua^Xo, Qxua^Xo, Qxua^Xo, Qxua^Xo, Qxua^Xo, Qxua^Xo, Qxua^Xo, Qxua^Xo, Qxua^Xo, Qxua^Xo, Qxua^Xo, Qxua^Xo, Qxua^Xo, Qxua^Xo, Qxua^Xo, Qxua^Xo, Qxua^Xo, Qxua^Xo, Qxua^Xo, Qxua^Xo, Qxua^Xo, Qxua^Xo, Qxua^Xo, Qxua^Xo, Qxua^Xo, Qxua^Xo, Qxua^Xo, Qxua^Xo, Qxua^Xo, Qxua^Xo, Qxua^Xo, Qxua^Xo, Qxua^Xo, Qxua^Xo, Qxua^Xo, Qxua^Xo, Qxua^Xo, Qxua^Xo, Qxua^Xo, Qxua^Xo, Qxua^Xo, Qxua^Xo, Qxua^Xo, Qxua^Xo, Qxua^Xo, Qxua^Xo, Qxua^Xo, Qxua^Xo, Qxua^Xo, Qxua^Xo, Qxua^Xo
Qxua^Xo, Qxua^Xo, Qxua^Xo, Qxua^Xo, Qxua^Xo, Qxua^Xo, Qxua^Xo, Qxua^Xo, Qxua^Xo, Qxua^Xo, Gs^Fp, Qxua^Xo, Qxua^Xo, Qxua^Xo, Qxua^Xo, Qxua^Xo, Qxua^Xo, Qxua^Xo, Qxua^Xo, Qxua^Xo, Qxua^Xo, Qxua^Xo, Qxua^Xo, Qxua^Xo, Qxua^Xo, Qxua^Xo, Hh^Fp, Qxua^Xo, Qxua^Xo, Qxua^Xo, Qxua^Xo, Qxua^Xo, Qxua^Xo, Qxua^Xo, Qxua^Xo, Qxua^Xo, Qxua^Xo, Qxua^Xo, Qxua^Xo, Qxua^Xo, Qxua^Xo, Qxua^Xo, Gs^Fp, Qxua^Xo, Qxua^Xo, Qxua^Xo, Qxua^Xo, Qxua^Xo, Qxua^Xo, Qxua^Xo, Qxua^Xo, Qxua^Xo, Qxua^Xo
Qxua^Xo, Qxua^Xo, Qxua^Xo, Qxua^Xo, Qxua^Xo, Qxua^Xo, Qxua^Xo, Qxua^Xo, Cud, Re, Re, Re, Re, Qxua^Xo, Qxua^Xo, Qxua^Xo, Qxua^Xo, Qxua^Xo, Qxua^Xo, Qxua^Xo, Qxua^Xo, Qxua^Xo, Qxua^Xo, Qxua^Xo, Gs^Fp, Khr, Chr, Khr, Gg, Qxua^Xo, Qxua^Xo, Qxua^Xo, Qxua^Xo, Qxua^Xo, Qxua^Xo, Qxua^Xo, Qxua^Xo, Qxua^Xo, Qxua^Xo, Qxua^Xo, Re, Re, Re, Re, Cud, Qxua^Xo, Qxua^Xo, Qxua^Xo, Qxua^Xo, Qxua^Xo, Qxua^Xo, Qxua^Xo, Qxua^Xo
Qxua^Xo, Qxua^Xo, Qxua^Xo, Qxua^Xo, Qxua^Xo, Qxua^Xo, Cud, 1 Kud, Cud, Cud, Gg, Hh, Re, Gg^Vh, Re, Qxua^Xo, Qxua^Xo, Qxua^Xo, Qxua^Xo, Qxua^Xo, Qxua^Xo, Qxua^Xo, Gg^Vh, Re, Rd, Rd, Gs^Fp, Rd, Rd, Gs^Fp, Gg, Qxua^Xo, Qxua^Xo, Qxua^Xo, Qxua^Xo, Qxua^Xo, Qxua^Xo, Qxua^Xo, Re, Gg^Vh, Re, Hh, Gg, Cud, Cud, 2 Kud, Cud, Qxua^Xo, Qxua^Xo, Qxua^Xo, Qxua^Xo, Qxua^Xo, Qxua^Xo
Qxua^Xo, Qxua^Xo, Qxua^Xo, Qxua^Xo, Gs, Gg, Hh, Cud, Gg, Wwf, Wwf, Gg, Gs^Fp, Gg, Hh, Re, Chr, Qxua^Xo, Qxua^Xo, Qxua^Xo, Hh, Gs^Fp, Rd, Rd, Hh, Gs^Fp, Mm, Gs^Fp, Hh, Rd, Rd, Hh, Gs^Fp, Qxua^Xo, Qxua^Xo, Qxua^Xo, Chr, Re, Hh, Gg, Gs^Fp, Gg, Wwf, Wwf, Gg, Cud, Hh, Gg, Gs, Qxua^Xo, Qxua^Xo, Qxua^Xo, Qxua^Xo
Qxua^Xo, Qxua^Xo, Qxua^Xo, Qxua^Xo, Qxua^Xo, Re, Re, Gg, Re, Gs^Fp, Re, Wwf, Wwf, Gg, Chr, Re, Re, Chr, Gg, Gs^Fp, Rd, Rd, Gs^Fp, Gg, Gg, Gg, Hh, Gg, Gg, Re, Hh, Rd, Rd, Gg, Gg, Chr, Re, Re, Chr, Gg, Wwf, Wwf, Re, Gs^Fp, Re, Gg, Re, Re, Qxua^Xo, Qxua^Xo, Qxua^Xo, Qxua^Xo, Qxua^Xo
Qxua^Xo, Qxua^Xo, Qxua^Xo, Qxua^Xo, Qxua^Xo, Qxua^Xo, Qxua^Xo, Gg^Vh, Re, Re, Gg, Re, Chr, Chw, Wwf, Gg, Hh, Gg, Chr, Rd, Re, Hh, Gs^Fp, Gg, Wot, Wwt, Wwrt, Wwt, Wot, Gg^Vh, Gs^Fp, Gs^Fp, Re, Rd, Chr, Gg, Hh, Gg, Wwf, Chw, Chr, Re, Gg, Re, Re, Gg^Vh, Qxua^Xo, Qxua^Xo, Qxua^Xo, Qxua^Xo, Qxua^Xo, Qxua^Xo, Qxua^Xo
Qxua^Xo, Qxua^Xo, Qxua^Xo, Qxua^Xo, Qxua^Xo, Qxua^Xo, Qxua^Xo, Qxua^Xo, Qxua^Xo, Gs^Fp, Hh^Fp, Re, Chr, Gg, Gs^Fp, Wwf, Wwf, Rd, Re, Gg, Wwf, Gg, Wot, Wot, Wwt, Wwrt, Hhd^Ftp, Wwrt, Wwf, Wot, Wot, Gg, Wwf, Gg, Re, Rd, Wwf, Wwf, Gs^Fp, Gg, Chr, Re, Hh^Fp, Gs^Fp, Qxua^Xo, Qxua^Xo, Qxua^Xo, Qxua^Xo, Qxua^Xo, Qxua^Xo, Qxua^Xo, Qxua^Xo, Qxua^Xo
Qxua^Xo, Qxua^Xo, Qxua^Xo, Qxua^Xo, Qxua^Xo, Qxua^Xo, Qxua^Xo, Qxua^Xo, Qxua^Xo, Qxua^Xo, Qxua^Xo, Re, Gs^Fp, Gg, Chr, Rd, Gg^Vh, Wwf, Wwf, Gs^Fms, Gs^Fms, Wwt, Wot, Wwt, Hhd, Gd^Ftp, Hhd, Wwrt, Gd, Wwt, Wot, Wwt, Gs^Fms, Gs^Fms, Wwf, Wwf, Gg^Vh, Rd, Chr, Gg, Gs^Fp, Re, Qxua^Xo, Qxua^Xo, Qxua^Xo, Qxua^Xo, Qxua^Xo, Qxua^Xo, Qxua^Xo, Qxua^Xo, Qxua^Xo, Qxua^Xo, Qxua^Xo
Qxua^Xo, Qxua^Xo, Qxua^Xo, Qxua^Xo, Qxua^Xo, Qxua^Xo, Qxua^Xo, Qxua^Xo, Qxua^Xo, Qxua^Xo, Hh, Gg, Rd, Rd, Re, Gg, Wwt, Hh, Re, Wwf, Wwf, Chr, Gd^Ftp, Gd, Gd, Gd^Ftp, Sm^Vhs, Hhd, Gd, Gd, Gd^Ftp, Chr, Wwf, Wwf, Re, Hh, Wwt, Gg, Re, Rd, Rd, Gg, Hh, Qxua^Xo, Qxua^Xo, Qxua^Xo, Qxua^Xo, Qxua^Xo, Qxua^Xo, Qxua^Xo, Qxua^Xo, Qxua^Xo, Qxua^Xo
Qxua^Xo, Qxua^Xo, Qxua^Xo, Qxua^Xo, Qxua^Xo, Qxua^Xo, Qxua^Xo, Qxua^Xo, Mm, Gs^Fp, Rd, Rd, Gs^Fp, Hh, Gg, Re, Wwt, Wwt, Wwt, Chw, Wwf, Wwf, Wwf, Re, Sm, Sm, Wwt, Sm, Hhd, Re, Wwf, Wwf, Wwf, Chw, Wwt, Wwt, Wwf, Re, Gg, Hh, Gs^Fp, Rd, Rd, Gs^Fp, Mm, Qxua^Xo, Qxua^Xo, Qxua^Xo, Qxua^Xo, Qxua^Xo, Qxua^Xo, Qxua^Xo, Qxua^Xo
Qxua^Xo, Qxua^Xo, Qxua^Xo, Qxua^Xo, Qxua^Xo, Qxua^Xo, Qxua^Xo, Qxua^Xo, Rd, Rd, Re, Gg, Gg, Gg^Vh, Wwt, Wwf, Wwt, Wwt, Gd, Re, Gd, Wwf, Wwf, Wwf, Wwf, Wwt, Khw, Wwt, Wwf, Wwf, Wwf, Wwf, Gd^Ftp, Re, Gd^Ftp, Wwt, Ss, Wot, Wwt, Gg^Vh, Gg, Gg, Re, Rd, Rd, Qxua^Xo, Qxua^Xo, Qxua^Xo, Qxua^Xo, Qxua^Xo, Qxua^Xo, Qxua^Xo, Qxua^Xo
Qxua^Xo, Qxua^Xo, Qxua^Xo, Qxua^Xo, Qxua^Xo, Qxua^Xo, Qxua^Xo, Qxua^Xo, Cv, Gs^Fp, Hh, Cv, Kv, Wot, Wwt, Ss, Hhd^Ftp, Wwf, Gd^Ftp, Gd, Md, Hhd, Gd^Vht, Gd^Ftp, Wwt, Chw, Ww^Vm, Chw, Wwt, Gd^Ftp, Gd^Vht, Hhd, Md, Gd, Gd^Ftp, Gd^Ftp, Hhd^Ftp, Ss, Wwt, Wot, Kv, Cv, Hh, Gs^Fp, Cv, Qxua^Xo, Qxua^Xo, Qxua^Xo, Qxua^Xo, Qxua^Xo, Qxua^Xo, Qxua^Xo, Qxua^Xo
Qxua^Xo, Qxua^Xo, Qxua^Xo, Qxua^Xo, Qxua^Xo, Qxua^Xo, Qxua^Xo, Qxua^Xo, Rd, Gs^Fp, Re, Cv, Gg, Wot, Wwt, Ss, Ss, Gd^Ftp, Gd^Ftp, Gd, Gd^Ftp, Hhd, Wwf, Gd^Ftp, Wwf, Chw, Khw, Chw, Wwf, Gd^Ftp, Wwf, Hhd, Gd, Gd, Gd, Wwf, Wwt, Ss, Wwt, Wot, Gg, Cv, Re, Gs^Fp, Rd, Qxua^Xo, Qxua^Xo, Qxua^Xo, Qxua^Xo, Qxua^Xo, Qxua^Xo, Qxua^Xo, Qxua^Xo
Qxua^Xo, Qxua^Xo, Qxua^Xo, Qxua^Xo, Qxua^Xo, Qxua^Xo, Qxua^Xo, Qxua^Xo, Mm, Rd, Rd, Gs^Fp, Hh, Gg, Gs^Fp, Wot, Wwf, Wwt, Wwt, Re, Wwf, Wwf, Wwf, Wwf, Hhd, Wwt, Wwt, Wwt, Sm, Wwf, Wwf, Wwf, Wwf, Re, Wwt, Wwt, Wwt, Wwf, Gs^Fp, Gg, Hh, Gs^Fp, Rd, Rd, Mm, Qxua^Xo, Qxua^Xo, Qxua^Xo, Qxua^Xo, Qxua^Xo, Qxua^Xo, Qxua^Xo, Qxua^Xo
Qxua^Xo, Qxua^Xo, Qxua^Xo, Qxua^Xo, Qxua^Xo, Qxua^Xo, Qxua^Xo, Qxua^Xo, Qxua^Xo, Gs^Fp, Gg^Vh, Rd, Rd, Gg, Re, Re, Wwt, Wwt, Re, Chw, Wwf, Wwf, Gd^Ftp, Re, Gd, Sm, Sm^Vhs, Sm, Gd, Re, Gd^Ftp, Wwf, Wwf, Chw, Re, Wwt, Wwt, Re, Re, Gg, Rd, Rd, Gg^Vh, Gs^Fp, Qxua^Xo, Qxua^Xo, Qxua^Xo, Qxua^Xo, Qxua^Xo, Qxua^Xo, Qxua^Xo, Qxua^Xo, Qxua^Xo
Qxua^Xo, Qxua^Xo, Qxua^Xo, Qxua^Xo, Qxua^Xo, Qxua^Xo, Qxua^Xo, Qxua^Xo, Qxua^Xo, Qxua^Xo, Qxua^Xo, Hh, Gg, Rd, Chr, Gg, Gg^Vh, Hh, Wwf, Wwf, Gs^Fms, Chr, Wot, Gd, Gd, Hhd, Hhd, Gd^Ftp, Hhd, Gd, Wot, Chr, Gs^Fms, Wwf, Wwf, Hh, Gg^Vh, Gg, Chr, Rd, Gg, Hh, Qxua^Xo, Qxua^Xo, Qxua^Xo, Qxua^Xo, Qxua^Xo, Qxua^Xo, Qxua^Xo, Qxua^Xo, Qxua^Xo, Qxua^Xo, Qxua^Xo
Qxua^Xo, Qxua^Xo, Qxua^Xo, Qxua^Xo, Qxua^Xo, Qxua^Xo, Qxua^Xo, Qxua^Xo, Qxua^Xo, Qxua^Xo, Hh^Fp, Re, Chr, Gg, Gs^Fp, Rd, Wwf, Wwf, Re, Gs^Fms, Wwf, Wwt, Wot, Wwt, Wwf, Wwrt, Gd^Ftp, Gd^Ftp, Wwt, Wwt, Wot, Ww, Wwf, Gs^Fms, Re, Wwf, Wwf, Rd, Gs^Fp, Gg, Chr, Re, Hh^Fp, Qxua^Xo, Qxua^Xo, Qxua^Xo, Qxua^Xo, Qxua^Xo, Qxua^Xo, Qxua^Xo, Qxua^Xo, Qxua^Xo, Qxua^Xo
Qxua^Xo, Qxua^Xo, Qxua^Xo, Qxua^Xo, Qxua^Xo, Qxua^Xo, Qxua^Xo, Qxua^Xo, Re, Gs^Fp, Gg, Re, Chr, Gg, Wwf, Wwf, Hh, Rd, Chr, Gg, Re, Gg, Gs^Fp, Wot, Wot, Wwrt, Wwrt, Wwrt, Wot, Wot, Gs^Fp, Gg, Re, Gg, Chr, Rd, Hh, Wwf, Wwf, Gg, Chr, Re, Gg, Gs^Fp, Re, Qxua^Xo, Qxua^Xo, Qxua^Xo, Qxua^Xo, Qxua^Xo, Qxua^Xo, Qxua^Xo, Qxua^Xo
Qxua^Xo, Qxua^Xo, Qxua^Xo, Qxua^Xo, Qxua^Xo, Qxua^Xo, Re, Gg^Vh, Re, Re, Re, Re, Wwf, Chw, Chr, Gg, Re, Gg, Gg, Rd, Rd, Hh, Gs^Fp, Gg, Gg, Wwt, Hh, Wwt, Gg, Gg^Vh, Hh, Gs^Fp, Rd, Rd, Gg, Gg, Re, Gg, Chr, Chw, Wwf, Re, Re, Re, Re, Gg^Vh, Re, Qxua^Xo, Qxua^Xo, Qxua^Xo, Qxua^Xo, Qxua^Xo, Qxua^Xo
Qxua^Xo, Qxua^Xo, Qxua^Xo, Qxua^Xo, Gs, Re, Hh, Gg, Gg, Gs^Fp, Wwf, Wwf, Gs^Fp, Gg, Hh, Re, Chr, Chr, Qxua^Xo, Gs^Fp, Hh, Rd, Rd, Gg, Hh, Gg, Mm, Gg, Hh, Re, Rd, Rd, Gs^Fp, Gg, Qxua^Xo, Chr, Chr, Re, Hh, Gg, Gs^Fp, Wwf, Wwf, Gs^Fp, Gg, Gg, Hh, Re, Gs, Qxua^Xo, Qxua^Xo, Qxua^Xo, Qxua^Xo
Qxua^Xo, Qxua^Xo, Qxua^Xo, Qxua^Xo, Qxua^Xo, Gg, Cud, Cud, Cud, Wwf, Gg, Gg, Re, Gg, Re, Re, Qxua^Xo, Qxua^Xo, Qxua^Xo, Qxua^Xo, Qxua^Xo, Gs^Fp, Gg^Vh, Rd, Rd, Gs^Fp, Gs^Fp, Gs^Fp, Rd, Rd, Gg, Hh, Qxua^Xo, Qxua^Xo, Qxua^Xo, Qxua^Xo, Qxua^Xo, Re, Re, Gg, Re, Gg, Gg, Wwf, Cud, Cud, Cud, Gg, Qxua^Xo, Qxua^Xo, Qxua^Xo, Qxua^Xo, Qxua^Xo
Qxua^Xo, Qxua^Xo, Qxua^Xo, Qxua^Xo, Qxua^Xo, Qxua^Xo, Qxua^Xo, 4 Kud, Cud, Cud, Re, Hh, Re, Gg^Vh, Qxua^Xo, Qxua^Xo, Qxua^Xo, Qxua^Xo, Qxua^Xo, Qxua^Xo, Qxua^Xo, Qxua^Xo, Qxua^Xo, Re, Gs^Fp, Rd, Chr, Rd, Gg, Gs^Fp, Qxua^Xo, Qxua^Xo, Qxua^Xo, Qxua^Xo, Qxua^Xo, Qxua^Xo, Qxua^Xo, Qxua^Xo, Qxua^Xo, Gg^Vh, Re, Hh, Re, Cud, Cud, 3 Kud, Qxua^Xo, Qxua^Xo, Qxua^Xo, Qxua^Xo, Qxua^Xo, Qxua^Xo, Qxua^Xo
Qxua^Xo, Qxua^Xo, Qxua^Xo, Qxua^Xo, Qxua^Xo, Qxua^Xo, Qxua^Xo, Qxua^Xo, Qxua^Xo, Re, Gs^Fp, Re, Qxua^Xo, Qxua^Xo, Qxua^Xo, Qxua^Xo, Qxua^Xo, Qxua^Xo, Qxua^Xo, Qxua^Xo, Qxua^Xo, Qxua^Xo, Qxua^Xo, Qxua^Xo, Qxua^Xo, Khr, Hh^Fp, Khr, Qxua^Xo, Qxua^Xo, Qxua^Xo, Qxua^Xo, Qxua^Xo, Qxua^Xo, Qxua^Xo, Qxua^Xo, Qxua^Xo, Qxua^Xo, Qxua^Xo, Qxua^Xo, Qxua^Xo, Re, Gs^Fp, Re, Qxua^Xo, Qxua^Xo, Qxua^Xo, Qxua^Xo, Qxua^Xo, Qxua^Xo, Qxua^Xo, Qxua^Xo, Qxua^Xo
Qxua^Xo, Qxua^Xo, Qxua^Xo, Qxua^Xo, Qxua^Xo, Qxua^Xo, Qxua^Xo, Qxua^Xo, Qxua^Xo, Qxua^Xo, Qxua^Xo, Qxua^Xo, Qxua^Xo, Qxua^Xo, Qxua^Xo, Qxua^Xo, Qxua^Xo, Qxua^Xo, Qxua^Xo, Qxua^Xo, Qxua^Xo, Qxua^Xo, Qxua^Xo, Qxua^Xo, Qxua^Xo, Qxua^Xo, Qxua^Xo, Qxua^Xo, Qxua^Xo, Qxua^Xo, Qxua^Xo, Qxua^Xo, Qxua^Xo, Qxua^Xo, Qxua^Xo, Qxua^Xo, Qxua^Xo, Qxua^Xo, Qxua^Xo, Qxua^Xo, Qxua^Xo, Qxua^Xo, Qxua^Xo, Qxua^Xo, Qxua^Xo, Qxua^Xo, Qxua^Xo, Qxua^Xo, Qxua^Xo, Qxua^Xo, Qxua^Xo, Qxua^Xo, Qxua^Xo
Qxua^Xo, Qxua^Xo, Qxua^Xo, Qxua^Xo, Qxua^Xo, Qxua^Xo, Qxua^Xo, Qxua^Xo, Qxua^Xo, Qxua^Xo, Qxua^Xo, Qxua^Xo, Qxua^Xo, Qxua^Xo, Qxua^Xo, Qxua^Xo, Qxua^Xo, Qxua^Xo, Qxua^Xo, Qxua^Xo, Qxua^Xo, Qxua^Xo, Qxua^Xo, Qxua^Xo, Qxua^Xo, Qxua^Xo, Qxua^Xo, Qxua^Xo, Qxua^Xo, Qxua^Xo, Qxua^Xo, Qxua^Xo, Qxua^Xo, Qxua^Xo, Qxua^Xo, Qxua^Xo, Qxua^Xo, Qxua^Xo, Qxua^Xo, Qxua^Xo, Qxua^Xo, Qxua^Xo, Qxua^Xo, Qxua^Xo, Qxua^Xo, Qxua^Xo, Qxua^Xo, Qxua^Xo, Qxua^Xo, Qxua^Xo, Qxua^Xo, Qxua^Xo, Qxua^Xo
Qxua^Xo, Qxua^Xo, Qxua^Xo, Qxua^Xo, Qxua^Xo, Qxua^Xo, Qxua^Xo, Qxua^Xo, Qxua^Xo, Qxua^Xo, Qxua^Xo, Qxua^Xo, Qxua^Xo, Qxua^Xo, Qxua^Xo, Qxua^Xo, Qxua^Xo, Qxua^Xo, Qxua^Xo, Qxua^Xo, Qxua^Xo, Qxua^Xo, Qxua^Xo, Qxua^Xo, Qxua^Xo, Qxua^Xo, Qxua^Xo, Qxua^Xo, Qxua^Xo, Qxua^Xo, Qxua^Xo, Qxua^Xo, Qxua^Xo, Qxua^Xo, Qxua^Xo, Qxua^Xo, Qxua^Xo, Qxua^Xo, Qxua^Xo, Qxua^Xo, Qxua^Xo, Qxua^Xo, Qxua^Xo, Qxua^Xo, Qxua^Xo, Qxua^Xo, Qxua^Xo, Qxua^Xo, Qxua^Xo, Qxua^Xo, Qxua^Xo, Qxua^Xo, Qxua^Xo
Qxua^Xo, Qxua^Xo, Qxua^Xo, Qxua^Xo, Qxua^Xo, Qxua^Xo, Qxua^Xo, Qxua^Xo, Qxua^Xo, Qxua^Xo, Qxua^Xo, Qxua^Xo, Qxua^Xo, Qxua^Xo, Qxua^Xo, Qxua^Xo, Qxua^Xo, Qxua^Xo, Qxua^Xo, Qxua^Xo, Qxua^Xo, Qxua^Xo, Qxua^Xo, Qxua^Xo, Qxua^Xo, Qxua^Xo, Qxua^Xo, Qxua^Xo, Qxua^Xo, Qxua^Xo, Qxua^Xo, Qxua^Xo, Qxua^Xo, Qxua^Xo, Qxua^Xo, Qxua^Xo, Qxua^Xo, Qxua^Xo, Qxua^Xo, Qxua^Xo, Qxua^Xo, Qxua^Xo, Qxua^Xo, Qxua^Xo, Qxua^Xo, Qxua^Xo, Qxua^Xo, Qxua^Xo, Qxua^Xo, Qxua^Xo, Qxua^Xo, Qxua^Xo, Qxua^Xo
Qxua^Xo, Qxua^Xo, Qxua^Xo, Qxua^Xo, Qxua^Xo, Qxua^Xo, Qxua^Xo, Qxua^Xo, Qxua^Xo, Qxua^Xo, Qxua^Xo, Qxua^Xo, Qxua^Xo, Qxua^Xo, Qxua^Xo, Qxua^Xo, Qxua^Xo, Qxua^Xo, Qxua^Xo, Qxua^Xo, Qxua^Xo, Qxua^Xo, Qxua^Xo, Qxua^Xo, Qxua^Xo, Qxua^Xo, Qxua^Xo, Qxua^Xo, Qxua^Xo, Qxua^Xo, Qxua^Xo, Qxua^Xo, Qxua^Xo, Qxua^Xo, Qxua^Xo, Qxua^Xo, Qxua^Xo, Qxua^Xo, Qxua^Xo, Qxua^Xo, Qxua^Xo, Qxua^Xo, Qxua^Xo, Qxua^Xo, Qxua^Xo, Qxua^Xo, Qxua^Xo, Qxua^Xo, Qxua^Xo, Qxua^Xo, Qxua^Xo, Qxua^Xo, Qxua^Xo
Qxua^Xo, Qxua^Xo, Qxua^Xo, Qxua^Xo, Qxua^Xo, Qxua^Xo, Qxua^Xo, Qxua^Xo, Qxua^Xo, Qxua^Xo, Qxua^Xo, Qxua^Xo, Qxua^Xo, Qxua^Xo, Qxua^Xo, Qxua^Xo, Qxua^Xo, Qxua^Xo, Qxua^Xo, Qxua^Xo, Qxua^Xo, Qxua^Xo, Qxua^Xo, Qxua^Xo, Qxua^Xo, Qxua^Xo, Qxua^Xo, Qxua^Xo, Qxua^Xo, Qxua^Xo, Qxua^Xo, Qxua^Xo, Qxua^Xo, Qxua^Xo, Qxua^Xo, Qxua^Xo, Qxua^Xo, Qxua^Xo, Qxua^Xo, Qxua^Xo, Qxua^Xo, Qxua^Xo, Qxua^Xo, Qxua^Xo, Qxua^Xo, Qxua^Xo, Qxua^Xo, Qxua^Xo, Qxua^Xo, Qxua^Xo, Qxua^Xo, Qxua^Xo, Qxua^Xo
Qxua^Xo, Qxua^Xo, Qxua^Xo, Qxua^Xo, Qxua^Xo, Qxua^Xo, Qxua^Xo, Qxua^Xo, Qxua^Xo, Qxua^Xo, Qxua^Xo, Qxua^Xo, Qxua^Xo, Qxua^Xo, Qxua^Xo, Qxua^Xo, Qxua^Xo, Qxua^Xo, Qxua^Xo, Qxua^Xo, Qxua^Xo, Qxua^Xo, Qxua^Xo, Qxua^Xo, Qxua^Xo, Qxua^Xo, Qxua^Xo, Qxua^Xo, Qxua^Xo, Qxua^Xo, Qxua^Xo, Qxua^Xo, Qxua^Xo, Qxua^Xo, Qxua^Xo, Qxua^Xo, Qxua^Xo, Qxua^Xo, Qxua^Xo, Qxua^Xo, Qxua^Xo, Qxua^Xo, Qxua^Xo, Qxua^Xo, Qxua^Xo, Qxua^Xo, Qxua^Xo, Qxua^Xo, Qxua^Xo, Qxua^Xo, Qxua^Xo, Qxua^Xo, Qxua^Xo
