border_size=1
usage=map

Xu          , Xu          , Xu          , Xu          , Xu          , Xu          , Xu          , Xu          , Xu          , Xu          , Xu          , Xu          , Xu          , Xu          , Xu          , Xu          , Xu          , Xu          , Xu          , Xu          , Xu          , Xu          , Xu          , Xu          , Xu          , Xu          , Xu          , Xu          , Xu          , Xu          , Xu          , Xu          , Xu          , Xu          , Xu          , Xu          , Xu          , Xu          , Xu          , Xu          , Xu          , Xu          , Xu          , Xu          , Xu          , Xu          , Xu          , Xu          , Xu          , Xu          , Xu          , Xu          , Xu          
Xu          , Xu          , Xu          , Xu          , Xu          , Xu          , Xu          , Xu          , Xu          , Xu          , Xu          , Xu          , Xu          , Xu          , Xu          , Xu          , Xu          , Xu          , Xu          , Xu          , Xu          , Xu          , Xu          , Xu          , Xu          , Xu          , Xu          , Xu          , Xu          , Xu          , Xu          , Xu          , Xu          , Xu          , Xu          , Xu          , Xu          , Xu          , Xu          , Xu          , Xu          , Xu          , Xu          , Xu          , Xu          , Xu          , Xu          , Xu          , Xu          , Xu          , Xu          , Xu          , Xu          
Xu          , Xu          , Xu          , Xu          , Xu          , Xu          , Xu          , Xu          , Xu          , Xu          , Xu          , Xu          , Xu          , Xu          , Xu          , Xu          , Xu          , Xu          , Xu          , Xu          , Xu          , Xu          , Xu          , Xu          , Xu          , Xu          , Xu          , Xu          , Xu          , Xu          , Xu          , Xu          , Xu          , Xu          , Xu          , Xu          , Xu          , Xu          , Xu          , Xu          , Xu          , Xu          , Xu          , Xu          , Xu          , Xu          , Xu          , Xu          , Xu          , Xu          , Xu          , Xu          , Xu          
Xu          , Xu          , Xu          , Xu          , Xu          , Xu          , Xu          , Xu          , Xu          , Xu          , Xu          , Xu          , Xu          , Xu          , Xu          , Xu          , Xu          , Xu          , Xu          , Xu          , Xu          , Xu          , Xu          , Xu          , Xu          , Xu          , Xu          , Xu          , Xu          , Xu          , Xu          , Xu          , Xu          , Xu          , Xu          , Xu          , Xu          , Xu          , Xu          , Xu          , Xu          , Xu          , Xu          , Xu          , Xu          , Xu          , Xu          , Xu          , Xu          , Xu          , Xu          , Xu          , Xu          
Xu          , Xu          , Xu          , Xu          , Xu          , Xu          , Xu          , Xu          , Xu          , Xu          , Xu          , Xu          , Xu          , Xu          , Xu          , Xu          , Xu          , Xu          , Xu          , Xu          , Xu          , Xu          , Xu          , Xu          , Xu          , Xu          , Xu          , Xu          , Xu          , Xu          , Xu          , Xu          , Xu          , Xu          , Xu          , Xu          , Xu          , Xu          , Xu          , Xu          , Xu          , Xu          , Xu          , Xu          , Xu          , Xu          , Xu          , Xu          , Xu          , Xu          , Xu          , Xu          , Xu          
Xu          , Xu          , Xu          , Xu          , Xu          , Xu          , Xu          , Xu          , Xu          , Xu          , Xu          , Xu          , Xu          , Xu          , Xu          , Xu          , Xu          , Xu          , Xu          , Xu          , Xu          , Xu          , Xu          , Xu          , Xu          , Xu          , Xu          , Xu          , Xu          , Xu          , Xu          , Xu          , Xu          , Xu          , Xu          , Xu          , Xu          , Xu          , Xu          , Xu          , Xu          , Xu          , Xu          , Xu          , Xu          , Xu          , Xu          , Xu          , Xu          , Xu          , Xu          , Xu          , Xu          
Xu          , Xu          , Xu          , Xu          , Xu          , Xu          , Xu          , Xu          , Xu          , Xu          , Xu          , Xu          , Xu          , Xu          , Xu          , Xu          , Xu          , Xu          , Xu          , Xu          , Xu          , Xu          , Xu          , Xu          , Xu          , Xu          , Xu          , Xu          , Xu          , Xu          , Xu          , Xu          , Xu          , Xu          , Xu          , Xu          , Xu          , Xu          , Xu          , Xu          , Xu          , Xu          , Xu          , Xu          , Xu          , Xu          , Xu          , Xu          , Xu          , Xu          , Xu          , Xu          , Xu          
Xu          , Xu          , Xu          , Xu          , Xu          , Xu          , Xu          , Xu          , Xu          , Xu          , Gs^Fp       , Xu          , Xu          , Xu          , Xu          , Xu          , Xu          , Xu          , Xu          , Xu          , Xu          , Xu          , Xu          , Xu          , Xu          , Xu          , Hh^Fp       , Xu          , Xu          , Xu          , Xu          , Xu          , Xu          , Xu          , Xu          , Xu          , Xu          , Xu          , Xu          , Xu          , Xu          , Xu          , Gs^Fp       , Xu          , Xu          , Xu          , Xu          , Xu          , Xu          , Xu          , Xu          , Xu          , Xu          
Xu          , Xu          , Xu          , Xu          , Xu          , Xu          , Xu          , Xu          , Cud         , Re          , Re          , Re          , Re          , Xu          , Xu          , Xu          , Xu          , Xu          , Xu          , Xu          , Xu          , Xu          , Xu          , Xu          , Gs^Fp       , Khr         , Chr         , Khr         , Gg          , Xu          , Xu          , Xu          , Xu          , Xu          , Xu          , Xu          , Xu          , Xu          , Xu          , Xu          , Re          , Re          , Re          , Re          , Cud         , Xu          , Xu          , Xu          , Xu          , Xu          , Xu          , Xu          , Xu          
Xu          , Xu          , Xu          , Xu          , Xu          , Xu          , Cud         , 1 Kud       , Cud         , Cud         , Gg          , Hh          , Re          , Gg^Vh       , Re          , Xu          , Xu          , Xu          , Xu          , Xu          , Xu          , Xu          , Gg^Vh       , Re          , Rd          , Rd          , Gs^Fp       , Rd          , Rd          , Gs^Fp       , Gg          , Xu          , Xu          , Xu          , Xu          , Xu          , Xu          , Xu          , Re          , Gg^Vh       , Re          , Hh          , Gg          , Cud         , Cud         , 2 Kud       , Cud         , Xu          , Xu          , Xu          , Xu          , Xu          , Xu          
Xu          , Xu          , Xu          , Xu          , Gs          , Gg          , Hh          , Cud         , Gg          , Wwf         , Wwf         , Gg          , Gs^Fp       , Gg          , Hh          , Re          , Chr         , Xu          , Xu          , Xu          , Hh          , Gs^Fp       , Rd          , Rd          , Hh          , Gs^Fp       , Mm          , Gs^Fp       , Hh          , Rd          , Rd          , Hh          , Gs^Fp       , Xu          , Xu          , Xu          , Chr         , Re          , Hh          , Gg          , Gs^Fp       , Gg          , Wwf         , Wwf         , Gg          , Cud         , Hh          , Gg          , Gs          , Xu          , Xu          , Xu          , Xu          
Xu          , Xu          , Xu          , Xu          , Xu          , Re          , Re          , Gg          , Re          , Gs^Fp       , Re          , Wwf         , Wwf         , Gg          , Chr         , Re          , Re          , Chr         , Gg          , Gs^Fp       , Rd          , Rd          , Gs^Fp       , Gg          , Gg          , Gg          , Hh          , Gg          , Gg          , Re          , Hh          , Rd          , Rd          , Gg          , Gg          , Chr         , Re          , Re          , Chr         , Gg          , Wwf         , Wwf         , Re          , Gs^Fp       , Re          , Gg          , Re          , Re          , Xu          , Xu          , Xu          , Xu          , Xu          
Xu          , Xu          , Xu          , Xu          , Xu          , Xu          , Xu          , Gg^Vh       , Re          , Re          , Gg          , Re          , Chr         , Chw         , Wwf         , Gg          , Hh          , Gg          , Chr         , Rd          , Re          , Hh          , Gs^Fp       , Gg          , Wo          , Ww          , Wwr         , Ww          , Wo          , Gg^Vh       , Gs^Fp       , Gs^Fp       , Re          , Rd          , Chr         , Gg          , Hh          , Gg          , Wwf         , Chw         , Chr         , Re          , Gg          , Re          , Re          , Gg^Vh       , Xu          , Xu          , Xu          , Xu          , Xu          , Xu          , Xu          
Xu          , Xu          , Xu          , Xu          , Xu          , Xu          , Xu          , Xu          , Xu          , Gs^Fp       , Hh^Fp       , Re          , Chr         , Gg          , Gs^Fp       , Wwf         , Wwf         , Rd          , Re          , Gg          , Wwf         , Gg          , Wo          , Wo          , Ww          , Wwr         , Hh^Fds      , Wwr         , Wwf         , Wo          , Wo          , Gg          , Wwf         , Gg          , Re          , Rd          , Wwf         , Wwf         , Gs^Fp       , Gg          , Chr         , Re          , Hh^Fp       , Gs^Fp       , Xu          , Xu          , Xu          , Xu          , Xu          , Xu          , Xu          , Xu          , Xu          
Xu          , Xu          , Xu          , Xu          , Xu          , Xu          , Xu          , Xu          , Xu          , Xu          , Xu          , Re          , Gs^Fp       , Gg          , Chr         , Rd          , Gg^Vh       , Wwf         , Wwf         , Gs^Fms      , Gs^Fms      , Ww          , Wo          , Ww          , Hh          , Gs^Fds      , Hh          , Wwr         , Gg          , Ww          , Wo          , Ww          , Gs^Fms      , Gs^Fms      , Wwf         , Wwf         , Gg^Vh       , Rd          , Chr         , Gg          , Gs^Fp       , Re          , Xu          , Xu          , Xu          , Xu          , Xu          , Xu          , Xu          , Xu          , Xu          , Xu          , Xu          
Xu          , Xu          , Xu          , Xu          , Xu          , Xu          , Xu          , Xu          , Xu          , Xu          , Hh          , Gg          , Rd          , Rd          , Re          , Gg          , Ww          , Hh          , Re          , Wwf         , Wwf         , Chr         , Gs^Fds      , Gg          , Gg          , Gs^Fds      , Ss^Vhs      , Hh          , Gg          , Gg          , Gs^Fds      , Chr         , Wwf         , Wwf         , Re          , Hh          , Ww          , Gg          , Re          , Rd          , Rd          , Gg          , Hh          , Xu          , Xu          , Xu          , Xu          , Xu          , Xu          , Xu          , Xu          , Xu          , Xu          
Xu          , Xu          , Xu          , Xu          , Xu          , Xu          , Xu          , Xu          , Mm          , Gs^Fp       , Rd          , Rd          , Gs^Fp       , Hh          , Gg          , Re          , Ww          , Ww          , Ww          , Chw         , Wwf         , Wwf         , Wwf         , Re          , Ss          , Ss          , Ww          , Ss          , Hh          , Re          , Wwf         , Wwf         , Wwf         , Chw         , Ww          , Ww          , Wwf         , Re          , Gg          , Hh          , Gs^Fp       , Rd          , Rd          , Gs^Fp       , Mm          , Xu          , Xu          , Xu          , Xu          , Xu          , Xu          , Xu          , Xu          
Xu          , Xu          , Xu          , Xu          , Xu          , Xu          , Xu          , Xu          , Rd          , Rd          , Re          , Gg          , Gg          , Gg^Vh       , Ww          , Wwf         , Ww          , Ww          , Gg          , Re          , Gg          , Wwf         , Wwf         , Wwf         , Wwf         , Ww          , Khw         , Ww          , Wwf         , Wwf         , Wwf         , Wwf         , Gs^Fds      , Re          , Gs^Fds      , Ww          , Ss          , Wo          , Ww          , Gg^Vh       , Gg          , Gg          , Re          , Rd          , Rd          , Xu          , Xu          , Xu          , Xu          , Xu          , Xu          , Xu          , Xu          
Xu          , Xu          , Xu          , Xu          , Xu          , Xu          , Xu          , Xu          , Cv          , Gs^Fp       , Hh          , Cv          , Kv          , Wo          , Ww          , Ss          , Hh^Fds      , Wwf         , Gs^Fds      , Gg          , Mm          , Hh          , Gg^Vh       , Gs^Fds      , Ww          , Chw         , Ww^Vm       , Chw         , Ww          , Gs^Fds      , Gg^Vh       , Hh          , Mm          , Gg          , Gs^Fds      , Gs^Fds      , Hh^Fds      , Ss          , Ww          , Wo          , Kv          , Cv          , Hh          , Gs^Fp       , Cv          , Xu          , Xu          , Xu          , Xu          , Xu          , Xu          , Xu          , Xu          
Xu          , Xu          , Xu          , Xu          , Xu          , Xu          , Xu          , Xu          , Rd          , Gs^Fp       , Re          , Cv          , Gg          , Wo          , Ww          , Ss          , Ss          , Gs^Fds      , Gs^Fds      , Gg          , Gs^Fds      , Hh          , Wwf         , Gs^Fds      , Wwf         , Chw         , Khw         , Chw         , Wwf         , Gs^Fds      , Wwf         , Hh          , Gg          , Gg          , Gg          , Wwf         , Ww          , Ss          , Ww          , Wo          , Gg          , Cv          , Re          , Gs^Fp       , Rd          , Xu          , Xu          , Xu          , Xu          , Xu          , Xu          , Xu          , Xu          
Xu          , Xu          , Xu          , Xu          , Xu          , Xu          , Xu          , Xu          , Mm          , Rd          , Rd          , Gs^Fp       , Hh          , Gg          , Gs^Fp       , Wo          , Wwf         , Ww          , Ww          , Re          , Wwf         , Wwf         , Wwf         , Wwf         , Hh          , Ww          , Ww          , Ww          , Ss          , Wwf         , Wwf         , Wwf         , Wwf         , Re          , Ww          , Ww          , Ww          , Wwf         , Gs^Fp       , Gg          , Hh          , Gs^Fp       , Rd          , Rd          , Mm          , Xu          , Xu          , Xu          , Xu          , Xu          , Xu          , Xu          , Xu          
Xu          , Xu          , Xu          , Xu          , Xu          , Xu          , Xu          , Xu          , Xu          , Gs^Fp       , Gg^Vh       , Rd          , Rd          , Gg          , Re          , Re          , Ww          , Ww          , Re          , Chw         , Wwf         , Wwf         , Gs^Fds      , Re          , Gg          , Ss          , Ss^Vhs      , Ss          , Gg          , Re          , Gs^Fds      , Wwf         , Wwf         , Chw         , Re          , Ww          , Ww          , Re          , Re          , Gg          , Rd          , Rd          , Gg^Vh       , Gs^Fp       , Xu          , Xu          , Xu          , Xu          , Xu          , Xu          , Xu          , Xu          , Xu          
Xu          , Xu          , Xu          , Xu          , Xu          , Xu          , Xu          , Xu          , Xu          , Xu          , Xu          , Hh          , Gg          , Rd          , Chr         , Gg          , Gg^Vh       , Hh          , Wwf         , Wwf         , Gs^Fms      , Chr         , Wo          , Gg          , Gg          , Hh          , Hh          , Gs^Fds      , Hh          , Gg          , Wo          , Chr         , Gs^Fms      , Wwf         , Wwf         , Hh          , Gg^Vh       , Gg          , Chr         , Rd          , Gg          , Hh          , Xu          , Xu          , Xu          , Xu          , Xu          , Xu          , Xu          , Xu          , Xu          , Xu          , Xu          
Xu          , Xu          , Xu          , Xu          , Xu          , Xu          , Xu          , Xu          , Xu          , Xu          , Hh^Fp       , Re          , Chr         , Gg          , Gs^Fp       , Rd          , Wwf         , Wwf         , Re          , Gs^Fms      , Wwf         , Ww          , Wo          , Ww          , Wwf         , Wwr         , Hh^Fds      , Gs^Fds      , Ww          , Ww          , Wo          , Ww          , Wwf         , Gs^Fms      , Re          , Wwf         , Wwf         , Rd          , Gs^Fp       , Gg          , Chr         , Re          , Hh^Fp       , Xu          , Xu          , Xu          , Xu          , Xu          , Xu          , Xu          , Xu          , Xu          , Xu          
Xu          , Xu          , Xu          , Xu          , Xu          , Xu          , Xu          , Xu          , Re          , Gs^Fp       , Gg          , Re          , Chr         , Gg          , Wwf         , Wwf         , Hh          , Rd          , Chr         , Gg          , Re          , Gg          , Gs^Fp       , Wo          , Wo          , Wwr         , Wwr         , Wwr         , Wo          , Wo          , Gs^Fp       , Gg          , Re          , Gg          , Chr         , Rd          , Hh          , Wwf         , Wwf         , Gg          , Chr         , Re          , Gg          , Gs^Fp       , Re          , Xu          , Xu          , Xu          , Xu          , Xu          , Xu          , Xu          , Xu          
Xu          , Xu          , Xu          , Xu          , Xu          , Xu          , Re          , Gg^Vh       , Re          , Re          , Re          , Re          , Wwf         , Chw         , Chr         , Gg          , Re          , Gg          , Gg          , Rd          , Rd          , Hh          , Gs^Fp       , Gg          , Gg          , Ww          , Hh          , Ww          , Gg          , Gg^Vh       , Hh          , Gs^Fp       , Rd          , Rd          , Gg          , Gg          , Re          , Gg          , Chr         , Chw         , Wwf         , Re          , Re          , Re          , Re          , Gg^Vh       , Re          , Xu          , Xu          , Xu          , Xu          , Xu          , Xu          
Xu          , Xu          , Xu          , Xu          , Gs          , Re          , Hh          , Gg          , Gg          , Gs^Fp       , Wwf         , Wwf         , Gs^Fp       , Gg          , Hh          , Re          , Chr         , Chr         , Xu          , Gs^Fp       , Hh          , Rd          , Rd          , Gg          , Hh          , Gg          , Mm          , Gg          , Hh          , Re          , Rd          , Rd          , Gs^Fp       , Gg          , Xu          , Chr         , Chr         , Re          , Hh          , Gg          , Gs^Fp       , Wwf         , Wwf         , Gs^Fp       , Gg          , Gg          , Hh          , Re          , Gs          , Xu          , Xu          , Xu          , Xu          
Xu          , Xu          , Xu          , Xu          , Xu          , Gg          , Cud         , Cud         , Cud         , Wwf         , Gg          , Gg          , Re          , Gg          , Re          , Re          , Xu          , Xu          , Xu          , Xu          , Xu          , Gs^Fp       , Gg^Vh       , Rd          , Rd          , Gs^Fp       , Gs^Fp       , Gs^Fp       , Rd          , Rd          , Gg          , Hh          , Xu          , Xu          , Xu          , Xu          , Xu          , Re          , Re          , Gg          , Re          , Gg          , Gg          , Wwf         , Cud         , Cud         , Cud         , Gg          , Xu          , Xu          , Xu          , Xu          , Xu          
Xu          , Xu          , Xu          , Xu          , Xu          , Xu          , Xu          , 4 Kud       , Cud         , Cud         , Re          , Hh          , Re          , Gg^Vh       , Xu          , Xu          , Xu          , Xu          , Xu          , Xu          , Xu          , Xu          , Xu          , Re          , Gs^Fp       , Rd          , Chr         , Rd          , Gg          , Gs^Fp       , Xu          , Xu          , Xu          , Xu          , Xu          , Xu          , Xu          , Xu          , Xu          , Gg^Vh       , Re          , Hh          , Re          , Cud         , Cud         , 3 Kud       , Xu          , Xu          , Xu          , Xu          , Xu          , Xu          , Xu          
Xu          , Xu          , Xu          , Xu          , Xu          , Xu          , Xu          , Xu          , Xu          , Re          , Gs^Fp       , Re          , Xu          , Xu          , Xu          , Xu          , Xu          , Xu          , Xu          , Xu          , Xu          , Xu          , Xu          , Xu          , Xu          , Khr         , Hh^Fp       , Khr         , Xu          , Xu          , Xu          , Xu          , Xu          , Xu          , Xu          , Xu          , Xu          , Xu          , Xu          , Xu          , Xu          , Re          , Gs^Fp       , Re          , Xu          , Xu          , Xu          , Xu          , Xu          , Xu          , Xu          , Xu          , Xu          
Xu          , Xu          , Xu          , Xu          , Xu          , Xu          , Xu          , Xu          , Xu          , Xu          , Xu          , Xu          , Xu          , Xu          , Xu          , Xu          , Xu          , Xu          , Xu          , Xu          , Xu          , Xu          , Xu          , Xu          , Xu          , Xu          , Xu          , Xu          , Xu          , Xu          , Xu          , Xu          , Xu          , Xu          , Xu          , Xu          , Xu          , Xu          , Xu          , Xu          , Xu          , Xu          , Xu          , Xu          , Xu          , Xu          , Xu          , Xu          , Xu          , Xu          , Xu          , Xu          , Xu          
Xu          , Xu          , Xu          , Xu          , Xu          , Xu          , Xu          , Xu          , Xu          , Xu          , Xu          , Xu          , Xu          , Xu          , Xu          , Xu          , Xu          , Xu          , Xu          , Xu          , Xu          , Xu          , Xu          , Xu          , Xu          , Xu          , Xu          , Xu          , Xu          , Xu          , Xu          , Xu          , Xu          , Xu          , Xu          , Xu          , Xu          , Xu          , Xu          , Xu          , Xu          , Xu          , Xu          , Xu          , Xu          , Xu          , Xu          , Xu          , Xu          , Xu          , Xu          , Xu          , Xu          
Xu          , Xu          , Xu          , Xu          , Xu          , Xu          , Xu          , Xu          , Xu          , Xu          , Xu          , Xu          , Xu          , Xu          , Xu          , Xu          , Xu          , Xu          , Xu          , Xu          , Xu          , Xu          , Xu          , Xu          , Xu          , Xu          , Xu          , Xu          , Xu          , Xu          , Xu          , Xu          , Xu          , Xu          , Xu          , Xu          , Xu          , Xu          , Xu          , Xu          , Xu          , Xu          , Xu          , Xu          , Xu          , Xu          , Xu          , Xu          , Xu          , Xu          , Xu          , Xu          , Xu          
Xu          , Xu          , Xu          , Xu          , Xu          , Xu          , Xu          , Xu          , Xu          , Xu          , Xu          , Xu          , Xu          , Xu          , Xu          , Xu          , Xu          , Xu          , Xu          , Xu          , Xu          , Xu          , Xu          , Xu          , Xu          , Xu          , Xu          , Xu          , Xu          , Xu          , Xu          , Xu          , Xu          , Xu          , Xu          , Xu          , Xu          , Xu          , Xu          , Xu          , Xu          , Xu          , Xu          , Xu          , Xu          , Xu          , Xu          , Xu          , Xu          , Xu          , Xu          , Xu          , Xu          
Xu          , Xu          , Xu          , Xu          , Xu          , Xu          , Xu          , Xu          , Xu          , Xu          , Xu          , Xu          , Xu          , Xu          , Xu          , Xu          , Xu          , Xu          , Xu          , Xu          , Xu          , Xu          , Xu          , Xu          , Xu          , Xu          , Xu          , Xu          , Xu          , Xu          , Xu          , Xu          , Xu          , Xu          , Xu          , Xu          , Xu          , Xu          , Xu          , Xu          , Xu          , Xu          , Xu          , Xu          , Xu          , Xu          , Xu          , Xu          , Xu          , Xu          , Xu          , Xu          , Xu          
Xu          , Xu          , Xu          , Xu          , Xu          , Xu          , Xu          , Xu          , Xu          , Xu          , Xu          , Xu          , Xu          , Xu          , Xu          , Xu          , Xu          , Xu          , Xu          , Xu          , Xu          , Xu          , Xu          , Xu          , Xu          , Xu          , Xu          , Xu          , Xu          , Xu          , Xu          , Xu          , Xu          , Xu          , Xu          , Xu          , Xu          , Xu          , Xu          , Xu          , Xu          , Xu          , Xu          , Xu          , Xu          , Xu          , Xu          , Xu          , Xu          , Xu          , Xu          , Xu          , Xu          
Xu          , Xu          , Xu          , Xu          , Xu          , Xu          , Xu          , Xu          , Xu          , Xu          , Xu          , Xu          , Xu          , Xu          , Xu          , Xu          , Xu          , Xu          , Xu          , Xu          , Xu          , Xu          , Xu          , Xu          , Xu          , Xu          , Xu          , Xu          , Xu          , Xu          , Xu          , Xu          , Xu          , Xu          , Xu          , Xu          , Xu          , Xu          , Xu          , Xu          , Xu          , Xu          , Xu          , Xu          , Xu          , Xu          , Xu          , Xu          , Xu          , Xu          , Xu          , Xu          , Xu          
