border_size=1
usage=map

_off^_usr   , _off^_usr   , _off^_usr   , _off^_usr   , _off^_usr   , _off^_usr   , _off^_usr   , _off^_usr   , _off^_usr   , _off^_usr   , _off^_usr   , _off^_usr   , _off^_usr   , _off^_usr   , _off^_usr   , _off^_usr   , _off^_usr   , _off^_usr   , _off^_usr   , _off^_usr   , _off^_usr   , _off^_usr   , _off^_usr   , _off^_usr   , _off^_usr   , _off^_usr   , _off^_usr   , _off^_usr   , _off^_usr   , _off^_usr   , _off^_usr   , _off^_usr   , _off^_usr   
_off^_usr   , Gg          , Gg          , Gg          , Gg          , Gg          , Gg          , Gg          , Gg          , Gg          , Gg          , Gg          , Gg          , Gg          , Gg          , Gg          , Gg          , Gg          , Gg          , Gg          , Gg          , Gg          , Gg          , Gg          , Gg          , Gg          , Gg          , Gg          , Gg          , Gg          , Gg          , Gg          , _off^_usr   
_off^_usr   , Gg          , Gg          , Gg          , Gg          , Gg          , Gg          , Gg          , Gg          , Gg          , Gg          , Gg          , Gg          , Gg          , Gg          , Gg          , Mm^Xm       , Gg          , Gg          , Gg          , Gg          , Gg          , Gg          , Gg          , Gg          , Gg          , Gg          , Gg          , Gg          , Gg          , Gg          , Gg          , _off^_usr   
_off^_usr   , Gg          , Gg          , Gg          , Gg          , Gg          , Gg          , Gg          , Gg          , Gg          , Gg          , Gg          , Gg          , Gg          , Mm^Xm       , Mm^Xm       , Mm^Xm       , Mm^Xm       , Mm^Xm       , Gg          , Gg          , Gg          , Gg          , Gg          , Gg          , Gg          , Gg          , Gg          , Gg          , Gg          , Gg          , Gg          , _off^_usr   
_off^_usr   , Gg          , Gg          , Gg          , Gg          , Gg          , Gg          , Gg          , Gg          , Gg          , Gg          , Gg          , Mm^Xm       , Mm^Xm       , Mm^Xm       , Mm^Xm       , Mm^Xm       , Mm^Xm       , Mm^Xm       , Mm^Xm       , Mm^Xm       , Gg          , Gg          , Gg          , Gg          , Gg          , Gg          , Gg          , Gg          , Gg          , Gg          , Gg          , _off^_usr   
_off^_usr   , Gg          , Gg          , Gg          , Gg          , Gg          , Gg          , Gg          , Gg          , Gg          , Mm^Xm       , Mm^Xm       , Mm^Xm       , Mm^Xm       , Mm^Xm       , Mm^Xm       , Gg^Vh       , Mm^Xm       , Mm^Xm       , Mm^Xm       , Mm^Xm       , Mm^Xm       , Mm^Xm       , Gg          , Gg          , Gg          , Gg          , Gg          , Gg          , Gg          , Gg          , Gg          , _off^_usr   
_off^_usr   , Gg          , Gg          , Gg          , Gg          , Gg          , Gg          , Gg          , Mm^Xm       , Mm^Xm       , Mm^Xm       , Mm^Xm       , Mm^Xm       , Mm^Xm       , Gg          , Gg          , Gg          , Gg          , Gg          , Mm^Xm       , Mm^Xm       , Mm^Xm       , Mm^Xm       , Mm^Xm       , Mm^Xm       , Gg          , Gg          , Gg          , Gg          , Gg          , Gg          , Gg          , _off^_usr   
_off^_usr   , Gg          , Gg          , Gg          , Gg          , Gg          , Mm^Xm       , Mm^Xm       , Mm^Xm       , Mm^Xm       , Mm^Xm       , Mm^Xm       , Gg          , Gg          , Gg^Vh       , Gg          , 1 Kh        , Gg          , Gg^Vh       , Gg          , Gg          , Mm^Xm       , Mm^Xm       , Mm^Xm       , Mm^Xm       , Mm^Xm       , Mm^Xm       , Gg          , Gg          , Gg          , Gg          , Gg          , _off^_usr   
_off^_usr   , Gg          , Gg          , Gg          , Mm^Xm       , Mm^Xm       , Mm^Xm       , Mm^Xm       , Mm^Xm       , Mm^Xm       , Mm^Xm       , Mm^Xm       , Ke          , Gg          , Ch          , Ch          , Ch          , Ch          , Ch          , Gg          , Ke          , Mm^Xm       , Mm^Xm       , Mm^Xm       , Mm^Xm       , Mm^Xm       , Mm^Xm       , Mm^Xm       , Mm^Xm       , Gg          , Gg          , Gg          , _off^_usr   
_off^_usr   , Gg          , Mm^Xm       , Mm^Xm       , Mm^Xm       , Mm^Xm       , Mm^Xm       , Mm^Xm       , Gg          , Gg          , Ke          , Rd          , Ce          , Gg          , Ch          , Ch          , Ch          , Ch          , Ch          , Gg          , Ce          , Rd          , Ke          , Gg          , Gg          , Mm^Xm       , Mm^Xm       , Mm^Xm       , Mm^Xm       , Mm^Xm       , Mm^Xm       , Gg          , _off^_usr   
_off^_usr   , Gg          , Mm^Xm       , Mm^Xm       , Mm^Xm       , Mm^Xm       , Gg          , Gg          , Gg^Vh       , Gg          , Gg          , Ce          , Gg^Vh       , Gg          , Ch          , Ch          , Gg          , Ch          , Ch          , Gg          , Gg^Vh       , Ce          , Gg          , Gg          , Gg^Vh       , Gg          , Gg          , Mm^Xm       , Mm^Xm       , Mm^Xm       , Mm^Xm       , Gg          , _off^_usr   
_off^_usr   , Gg          , Mm^Xm       , Mm^Xm       , Mm^Xm       , Gg^Vh       , Gg          , Gg          , Ch          , Ch          , Ch          , Gg          , Gg          , Gg          , Gg          , Kh          , Gg          , Kh          , Gg          , Gg          , Gg          , Gg          , Ch          , Ch          , Ch          , Gg          , Gg          , Gg^Vh       , Mm^Xm       , Mm^Xm       , Mm^Xm       , Gg          , _off^_usr   
_off^_usr   , Gg          , Mm^Xm       , Mm^Xm       , Mm^Xm       , Gg          , Gg          , 6 Kh        , Ch          , Ch          , Ch          , Ch          , Gg          , Gg          , Gg          , Gg          , Ke          , Gg          , Gg          , Gg          , Gg          , Ch          , Ch          , Ch          , Ch          , 2 Kh        , Gg          , Gg          , Mm^Xm       , Mm^Xm       , Mm^Xm       , Gg          , _off^_usr   
_off^_usr   , Gg          , Mm^Xm       , Mm^Xm       , Mm^Xm       , Gg          , Gg^Vh       , Ch          , Ch          , Ch          , Gg          , Kh          , Gg          , Gg          , Gg^Vh       , Gg          , Ce          , Gg          , Gg^Vh       , Gg          , Gg          , Kh          , Gg          , Ch          , Ch          , Ch          , Gg^Vh       , Gg          , Mm^Xm       , Mm^Xm       , Mm^Xm       , Gg          , _off^_usr   
_off^_usr   , Gg          , Mm^Xm       , Mm^Xm       , Mm^Xm       , Gg          , Gg          , Ch          , Ch          , Ch          , Kh          , Gg          , Ke          , Gg          , Ce          , Ce          , Re^Gvs      , Ce          , Ce          , Gg          , Ke          , Gg          , Kh          , Ch          , Ch          , Ch          , Gg          , Gg          , Mm^Xm       , Mm^Xm       , Mm^Xm       , Gg          , _off^_usr   
_off^_usr   , Gg          , Mm^Xm       , Mm^Xm       , Mm^Xm       , Gg          , Ke          , Gg          , Gg          , Ch          , Gg          , Gg          , Gg          , Ce          , Re^Gvs      , Re^Gvs      , Re^Gvs      , Re^Gvs      , Re^Gvs      , Ce          , Gg          , Gg          , Gg          , Ch          , Gg          , Gg          , Ke          , Gg          , Mm^Xm       , Mm^Xm       , Mm^Xm       , Gg          , _off^_usr   
_off^_usr   , Gg          , Mm^Xm       , Mm^Xm       , Mm^Xm       , Mm^Xm       , Rd          , Ce          , Gg^Vh       , Gg          , Gg          , Gg          , Gg^Vh       , Ce          , Re^Gvs      , Re^Gvs      , Gg^Vh       , Re^Gvs      , Re^Gvs      , Ce          , Gg^Vh       , Gg          , Gg          , Gg          , Gg^Vh       , Ce          , Rd          , Mm^Xm       , Mm^Xm       , Mm^Xm       , Mm^Xm       , Gg          , _off^_usr   
_off^_usr   , Gg          , Mm^Xm       , Mm^Xm       , Mm^Xm       , Mm^Xm       , Ke          , Ce          , Gg          , Gg          , Gg          , Gg          , Gg          , Ce          , Re^Gvs      , Re^Gvs      , Re^Gvs      , Re^Gvs      , Re^Gvs      , Ce          , Gg          , Gg          , Gg          , Gg          , Gg          , Ce          , Ke          , Mm^Xm       , Mm^Xm       , Mm^Xm       , Mm^Xm       , Gg          , _off^_usr   
_off^_usr   , Gg          , Mm^Xm       , Mm^Xm       , Mm^Xm       , Gg          , Gg          , Gg          , Ch          , Ch          , Kh          , Gg          , Ke          , Ce          , Ce          , Re^Gvs      , Re^Gvs      , Re^Gvs      , Ce          , Ce          , Ke          , Gg          , Kh          , Ch          , Ch          , Gg          , Gg          , Gg          , Mm^Xm       , Mm^Xm       , Mm^Xm       , Gg          , _off^_usr   
_off^_usr   , Gg          , Mm^Xm       , Mm^Xm       , Mm^Xm       , Gg          , Gg^Vh       , Ch          , Ch          , Ch          , Gg          , Gg          , Gg          , Gg          , Gg^Vh       , Ce          , Ce          , Ce          , Gg^Vh       , Gg          , Gg          , Gg          , Gg          , Ch          , Ch          , Ch          , Gg^Vh       , Gg          , Mm^Xm       , Mm^Xm       , Mm^Xm       , Gg          , _off^_usr   
_off^_usr   , Gg          , Mm^Xm       , Mm^Xm       , Mm^Xm       , Gg          , Gg          , Ch          , Ch          , Ch          , Ch          , Kh          , Gg          , Gg          , Gg          , Gg          , Ke          , Gg          , Gg          , Gg          , Gg          , Kh          , Ch          , Ch          , Ch          , Ch          , Gg          , Gg          , Mm^Xm       , Mm^Xm       , Mm^Xm       , Gg          , _off^_usr   
_off^_usr   , Gg          , Mm^Xm       , Mm^Xm       , Mm^Xm       , Gg          , Gg          , 5 Kh        , Ch          , Ch          , Ch          , Ch          , Gg          , Gg          , Gg          , Gg          , Gg          , Gg          , Gg          , Gg          , Gg          , Ch          , Ch          , Ch          , Ch          , 3 Kh        , Gg          , Gg          , Mm^Xm       , Mm^Xm       , Mm^Xm       , Gg          , _off^_usr   
_off^_usr   , Gg          , Mm^Xm       , Mm^Xm       , Mm^Xm       , Gg^Vh       , Gg          , Gg          , Gg^Vh       , Ch          , Gg          , Gg          , Gg^Vh       , Gg          , Ch          , Kh          , Gg          , Kh          , Ch          , Gg          , Gg^Vh       , Gg          , Gg          , Ch          , Gg^Vh       , Gg          , Gg          , Gg^Vh       , Mm^Xm       , Mm^Xm       , Mm^Xm       , Gg          , _off^_usr   
_off^_usr   , Gg          , Mm^Xm       , Mm^Xm       , Mm^Xm       , Mm^Xm       , Mm^Xm       , Gg          , Gg          , Gg          , Ke          , Ce          , Ce          , Gg          , Ch          , Ch          , Ch          , Ch          , Ch          , Gg          , Ce          , Ce          , Ke          , Gg          , Gg          , Gg          , Mm^Xm       , Mm^Xm       , Mm^Xm       , Mm^Xm       , Mm^Xm       , Gg          , _off^_usr   
_off^_usr   , Gg          , Gg          , Mm^Xm       , Mm^Xm       , Mm^Xm       , Mm^Xm       , Mm^Xm       , Mm^Xm       , Gg          , Mm^Xm       , Rd          , Ke          , Gg          , Ch          , Ch          , Ch          , Ch          , Ch          , Gg          , Ke          , Rd          , Mm^Xm       , Gg          , Mm^Xm       , Mm^Xm       , Mm^Xm       , Mm^Xm       , Mm^Xm       , Mm^Xm       , Gg          , Gg          , _off^_usr   
_off^_usr   , Gg          , Gg          , Gg          , Gg          , Mm^Xm       , Mm^Xm       , Mm^Xm       , Mm^Xm       , Mm^Xm       , Mm^Xm       , Mm^Xm       , Gg          , Gg          , Gg^Vh       , Ch          , 4 Kh        , Ch          , Gg^Vh       , Gg          , Gg          , Mm^Xm       , Mm^Xm       , Mm^Xm       , Mm^Xm       , Mm^Xm       , Mm^Xm       , Mm^Xm       , Gg          , Gg          , Gg          , Gg          , _off^_usr   
_off^_usr   , Gg          , Gg          , Gg          , Gg          , Gg          , Gg          , Mm^Xm       , Mm^Xm       , Mm^Xm       , Mm^Xm       , Mm^Xm       , Mm^Xm       , Gg          , Gg          , Gg          , Gg          , Gg          , Gg          , Gg          , Mm^Xm       , Mm^Xm       , Mm^Xm       , Mm^Xm       , Mm^Xm       , Mm^Xm       , Gg          , Gg          , Gg          , Gg          , Gg          , Gg          , _off^_usr   
_off^_usr   , Gg          , Gg          , Gg          , Gg          , Gg          , Gg          , Gg          , Gg          , Mm^Xm       , Mm^Xm       , Mm^Xm       , Mm^Xm       , Mm^Xm       , Mm^Xm       , Gg          , Gg^Vh       , Gg          , Mm^Xm       , Mm^Xm       , Mm^Xm       , Mm^Xm       , Mm^Xm       , Mm^Xm       , Gg          , Gg          , Gg          , Gg          , Gg          , Gg          , Gg          , Gg          , _off^_usr   
_off^_usr   , Gg          , Gg          , Gg          , Gg          , Gg          , Gg          , Gg          , Gg          , Gg          , Gg          , Mm^Xm       , Mm^Xm       , Mm^Xm       , Mm^Xm       , Mm^Xm       , Mm^Xm       , Mm^Xm       , Mm^Xm       , Mm^Xm       , Mm^Xm       , Mm^Xm       , Gg          , Gg          , Gg          , Gg          , Gg          , Gg          , Gg          , Gg          , Gg          , Gg          , _off^_usr   
_off^_usr   , Gg          , Gg          , Gg          , Gg          , Gg          , Gg          , Gg          , Gg          , Gg          , Gg          , Gg          , Gg          , Mm^Xm       , Mm^Xm       , Mm^Xm       , Mm^Xm       , Mm^Xm       , Mm^Xm       , Mm^Xm       , Gg          , Gg          , Gg          , Gg          , Gg          , Gg          , Gg          , Gg          , Gg          , Gg          , Gg          , Gg          , _off^_usr   
_off^_usr   , Gg          , Gg          , Gg          , Gg          , Gg          , Gg          , Gg          , Gg          , Gg          , Gg          , Gg          , Gg          , Gg          , Gg          , Mm^Xm       , Mm^Xm       , Mm^Xm       , Gg          , Gg          , Gg          , Gg          , Gg          , Gg          , Gg          , Gg          , Gg          , Gg          , Gg          , Gg          , Gg          , Gg          , _off^_usr   
_off^_usr   , Gg          , Gg          , Gg          , Gg          , Gg          , Gg          , Gg          , Gg          , Gg          , Gg          , Gg          , Gg          , Gg          , Gg          , Gg          , Gg          , Gg          , Gg          , Gg          , Gg          , Gg          , Gg          , Gg          , Gg          , Gg          , Gg          , Gg          , Gg          , Gg          , Gg          , Gg          , _off^_usr   
_off^_usr   , _off^_usr   , _off^_usr   , _off^_usr   , _off^_usr   , _off^_usr   , _off^_usr   , _off^_usr   , _off^_usr   , _off^_usr   , _off^_usr   , _off^_usr   , _off^_usr   , _off^_usr   , _off^_usr   , _off^_usr   , _off^_usr   , _off^_usr   , _off^_usr   , _off^_usr   , _off^_usr   , _off^_usr   , _off^_usr   , _off^_usr   , _off^_usr   , _off^_usr   , _off^_usr   , _off^_usr   , _off^_usr   , _off^_usr   , _off^_usr   , _off^_usr   , _off^_usr   
