border_size=1
usage=map

Aa^Fpa, Aa^Fpa, Aa^Fpa, Aa^Fpa, Aa^Fpa, Ha, Rr, Ha, Ai, Ai, Ww, Aa, Ha, Ha, Ha, Ms, Ms, Aa^Fpa, Aa^Fpa, Aa^Fpa, Aa, Aa, Aa, Aa, Aa^Fpa, Ai, Ai
Aa^Fpa, Aa^Fpa, Ha, Aa^Fpa, Aa, Aa^Uf, Gs, Rr, Gll^Fp, Ai, Ww, Ww, Cv, 1 Kv, Cv, Aa^Fpa, Hh, Aa^Vhca, Aa, Aa, Aa, Aa^Fpa, Ha, Ai, Ai, Ai, Ai
Aa^Fpa, Aa^Fpa, Aa, Aa, Aa^Vea, Gd, Gs, Rr, Rr, Ww, Ww^Bw/, Cv, Rr, Cv, Rr, Cv, Rr, Rr, Rr, Gd, Gll^Fp, Mm, Hh, Ai, Ww, Ai, Aa^Fpa
Aa, Gd, Hhd, Gd, Gs, Gs, Wwf, Aa^Uf, Ww, Ww^Bw\, Ww, Gg^Efm, Gg^Vh, Rr, Re^Gvs, Re^Gvs, Wwf, Hh, Rr, Re^Uf, Ww, Gg, Ww, Ww, Ww, Aa^Fpa, Aa^Fpa
Ha, Gd, Gs, Gs, Gg, Gg, Ww, Ww, Ww, Ww, Ww, Gll^Fp, Gg^Efm, Rr, Re^Gvs, Re^Gvs, Re^Gvs, Wwf, Gg, Rr, Wwf, Ww, Ai, Ww, Aa, Gd, Aa^Fpa
Ha, Aa, Gs, Gg, Gg, Ai, Wwf, Ww, Gg, Hh, Gs, Gs, Gs, Rr, Gg^Wm, Re^Gvs, Gs, Gll^Fp, Wwr, Wwf, Wwf, Wwf, Aa^Vha, Ai, Aa, Aa, Ha
Ha, Aa^Uf, Cha, Hh, Gg, Gll^Fp, Wwf, Wwf, Wwf, Gg^Vh, Gg, Gs, Gg, Rr, Mm, Gll^Fmw, Gs, Ss^Vhs, Ww, Wwf, Rr, Gg^Fet, Gg, Gg, Gg, Aa, Ha
Aa, Aa, Aa^Vha, Gll^Fp, Gg, Gg, Ww, Ww, Gll^Fmw, Gs, Gs, Gs, Gs, Rr, Hh, Hh, Gg, Ww, Ww, Ww, Hh, Rr, Gg, Gg, Ha, Aa, Aa
Aa, Gs, Gs, Gg, Gg, Ww, Ww, Ww, Mm, Hh, Rr, Gll^Fmw, Rr, Rr, Gg, Gg, Gs, Gll^Fmw, Ww, Ww, Gg, Rr, Gg, Kha, Aa^Uf, Aa^Fpa, Aa
Aa^Fpa, Aa, Gs, Gg, Gg, Hh, Wwf, Ww, Rr, Rr, Gg, Rr, Gs^Uf, Rr, Gg, Gg^Ve, Gs, Ww, Ww, Ww, Rp, Rr, Gg, Gg, Gg, Gd, Ha
Aa^Fpa, Gll^Fp, Hh, Gg^Efm, Gg^Efm, Gg, Chw, Ww^Bw/, Ww, Gg, Gll^Fdw, Gg, Gg, Rr, Gg, Gll^Fdw, Gll^Fdw, Ww, Ww, Hh, Rr, Gg, Mm, Hh, Gg, Gd, Ha
Aa, Gd^Efm, Gs, Gg^Efm, Gg^Efm, Gg, Rp, Wwf, Ww, Wwr, Ss, Hh, Wwf, Wwf, Wwf, Chs, Ss, Ss, Wwf, Gg, Rr, Gg, Gll^Fp, Hh, Gll^Fp, Gs, Aa
Ms, Gd, Gll^Fp, Gs, Gll^Fp, Gg, Rp, Gll^Fmw, Wwf, Ss^Uf, Ss, Ss, Wwf, Hhd^Fmw, Wwf, Ss, Ss, Ss^Uf, Ww, Gs^Fmw, Rr, Gg, Gg, Gg, Gg, Gs, Ms
Ms, Gd, Gg, Hh, Mm, Gg, Rp, Gg, Ww, Ss, Gll^Fdw, Chs, Gg, Wwf, Gg, Hh, Gll^Fdw, Wwr, Ww, Wwf, Chw, Gg, Gg^Efm, Gg^Efm, Hhd, Gd^Efm, Ha
Aa, Gd, Gd, Hh, Gg, Gg, Rp, Hh, Ww, Ww, Gs, Gll^Fdw, Gg, Rp, Gg^Uf, Gg, Gg, Gg, Rp, Ww^Bw/r, Wwf, Gg, Gg, Gg^Efm, Gd, Gll^Fp, Aa
Ha, Gd, Aa^Uf, Gs, Gg, Rp, Gg, Ww, Ww, Ww, Gg, Gg^Ve, Gg, Rp, Rp, Rp, Rp, Rp, Mm, Ww, Ww, Hh, Gg, Gs, Gd, Aa, Aa
Ha, Aa^Fpa, Ha, Kha, Gg, Rp, Hh, Ww, Ww, Gll^Fmw, Gg, Gg, Hh, Rp, Re^Gvs, Gs^Fmw, Re^Gvs, Hh, Gs^Fmw, Ww, Ww, Ww, Gg, Gs, Aa^Vha, Gd, Aa
Ha, Aa, Gd, Gs, Gg, Rp, Rp, Ww, Ww, Ww, Gg, Hh, Mm, Rp, Re^Gvs, Re^Gvs, Re^Gvs, Gg, Wwf, Ww, Wwf, Gg, Gs, Gll^Fp, Cha, Aa, Ha
Ms, Aa, Aa, Gs, Aa^Vha, Gll^Fp, Wwf, Wwf, Wwr, Ss^Vhs, Gg, Gll^Fmw, Gg^Wm, Rp, Gg, Re^Gvs, Re^Gvs, Gg^Vh, Gg, Wwf, Wwf, Gs^Fp, Gg, Hh, Gd, Aa^Uf, Ha
Aa^Fpa, Aa, Aa, Ai, Ai, Wwf, Wwf, Wwf, Gg, Gll^Fp, Re^Gvs, Re^Gvs, Re^Gvs, Rp, Gg^Efm, Re^Gvs, Ww, Hh, Ww, Ww, Ww, Ai, Gg, Gs, Gd, Aa, Ha
Aa^Fpa, Gd, Ww, Ww, Ww, Ww, Ww, Rp, Rp, Wwf, Wwf, Re^Gvs, Re^Gvs, Rp, Gg^Vh, Gll^Fp, Ww, Ww, Ww, Ww, Wwf, Gg, Gg, Gs, Hhd, Gd, Ms
Aa^Fpa, Aa^Fpa, Ww, Ww, Hhd, Gg, Gll^Fp, Re^Uf, Rp, Hh, Rp, Re^Gvs, Rp, Rp, Rp, Gg^Efm, Ww^Bw/, Ww^Bw\, Rp, Aa^Uf, Gg, Gg, Aa^Vea, Gs, Gd, Gd, Ha
Ai, Ww, Ww, Ai, Ha, Md, Gd, Gg, Gs, Rp, Hhd, Cv, Cv, Cv, Cv, Cv, Ww, Ww, Gs^Fp, Rp, Gs, Gs, Aa, Aa, Aa, Gd, Ha
Ai, Ai, Ww, Ww, Aa, Aa^Fpa, Aa, Aa^Uf, Aa, Aa^Vha, Aa, Aa, Aa^Fpa, 2 Kv, Aa, Ww, Ww, Ww, Ww, Rp, Gd, Re^Uf, Re^Uf, Ha, Aa^Fpa, Aa^Fpa, Aa^Fpa
Ai, Aa^Fpa, Aa^Fpa, Aa^Fpa, Aa^Fpa, Aa^Fpa, Aa^Fpa, Ha, Ms, Ms, Aa^Fpa, Aa^Fpa, Aa^Fpa, Aa^Fpa, Aa^Fpa, Aa^Fpa, Ai, Ai, Ww, Rp, Aa^Fpa, Aa^Uf, Aa^Fpa, Aa^Fpa, Aa^Fpa, Aa^Uf, Aa^Fpa
