border_size=1
usage=map

Aa^Fpa, Aa^Fpa, Aa^Fpa, Aa^Fpa, Aa^Fpa, Ha, Rr, Ha, Ai, Ai, Ww, Aa, Ha, Ha, Ha, Ms, Ms, Aa^Fpa, Aa^Fpa, Aa^Fpa, Aa, Aa, Aa, Aa, Aa^Fpa, Ai, Ai
Aa^Fpa, Aa^Fpa, Ha, Aa^Fpa, Aa, Aa^Uf, Gg, Rr, Gs^Fp, Ai, Ww, Ww, Cv, 1 Kv, Cv, Aa^Fpa, Hh, Aa^Vha, Aa, Aa, Aa, Aa^Fpa, Ha, Ai, Ai, Ai, Ai
Aa^Fpa, Aa^Fpa, Aa, Aa, Aa^Vea, Gg, Gg, Rr, Rr, Ww, Ww^Bw/, Cv, Rr, Cv, Rr, Cv, Rr, Rr, Rr, Gg, Gs^Fp, Mm, Hh, Ai, Ww, Ai, Aa^Fpa
Aa, Gd, Hh, Gg, Gg, Gg, Wwf, Aa^Uf, Ww, Ww^Bw\, Ww, Gg^Efm, Gg^Vh, Rr, Re^Gvs, Re^Gvs, Ww, Hh, Rr, Re^Uf, Ww, Gg, Ww, Ww, Ww, Aa^Fpa, Aa^Fpa
Ha, Gd, Gg, Gg, Gg, Gg, Ww, Ww, Ww, Ww, Ww, Gs^Fp, Gg^Efm, Rr, Re^Gvs, Re^Gvs, Re^Gvs, Ww, Gg, Rr, Wwf, Ww, Ai, Ww, Aa, Gd, Aa^Fpa
Ha, Aa, Gg, Gg, Gg, Ai, Wwf, Ww, Gg, Hh, Gs, Gs, Gs, Rr, Gg^Wm, Re^Gvs, Gg, Gs^Fp, Wwr, Wwf, Wwf, Wwf, Aa^Vha, Ai, Aa, Aa, Ha
Ha, Aa^Uf, Chr, Hh, Gg, Gll^Fp, Wwf, Wwf, Wwf, Gg^Vh, Gg, Gs, Gg, Rr, Mm, Gs^Fmw, Gg, Ss^Vhs, Ww, Wwf, Rr, Gg^Fet, Gg, Gg, Gg, Aa, Ha
Aa, Aa, Aa^Vha, Gll^Fp, Gg, Gg, Ww, Ww, Gs^Fmw, Gs, Gs, Gs, Gs, Rr, Hh, Hh, Gg, Ww, Ww, Ww, Hh, Rr, Gg, Gg, Ha, Aa, Aa
Aa, Gg, Gg, Gg, Gg, Ww, Ww, Ww, Mm, Hh, Rr, Gs^Fmw, Rr, Rr, Gg, Gg, Gg, Gs^Fmw, Ww, Ww, Gg, Rr, Gg, Khr, Aa^Uf, Aa^Fpa, Aa
Aa^Fpa, Aa, Gg, Gg, Gg, Hh, Wwf, Ww, Rr, Rr, Gg, Rr, Gg^Uf, Rr, Gg, Gg^Ve, Gg, Ww, Ww, Ww, Gg, Rr, Gg, Gg, Gg, Gd, Ha
Aa^Fpa, Gll^Fp, Hh, Gg^Efm, Gg^Efm, Gg, Chw, Ww^Bw/, Ww, Gg, Gs^Fdw, Gg, Gg, Rr, Gg, Gs^Fdw, Gs^Fdw, Ww, Ww, Hh, Rr, Rr, Mm, Hh, Gg, Gd, Ha
Aa, Gd^Efm, Gg, Gg^Efm, Gg^Efm, Gg, Rp, Wwf, Ww, Wwr, Ss, Hh, Wwf, Wwf, Wwf, Chs, Ss, Ss, Ww, Gg, Rr, Gg, Gs^Fp, Hh, Gs^Fp, Gg, Aa
Ms, Gd, Gll^Fp, Gg, Gll^Fp, Gg, Rp, Gll^Fmw, Ww, Ss^Uf, Ss, Ss, Wwf, Hh^Fmw, Wwf, Ss, Ss, Ss^Uf, Ww, Gs^Fmw, Rr, Gg, Gg, Gg, Gg, Gg, Ms
Ms, Gd, Gg, Hh, Mm, Gg, Rp, Gg, Ww, Ss, Gs^Fdw, Chs, Gg, Wwf, Gg, Hh, Gs^Fdw, Wwr, Ww, Wwf, Chw, Gg, Gg^Efm, Gg^Efm, Hh, Gd^Efm, Ha
Aa, Gd, Gd, Hh, Gg, Rp, Gg, Hh, Ww, Ww, Gg, Gs^Fdw, Gg, Rp, Gg^Uf, Gg, Gg, Gg, Rp, Ww^Bw/, Wwf, Gg, Gg, Gg^Efm, Gd, Gs^Fp, Aa
Ha, Gd, Aa^Uf, Gg, Gg, Rp, Gg, Ww, Ww, Ww, Gg, Gg^Ve, Gg, Rp, Rp, Rp, Rp, Rp, Mm, Ww, Ww, Hh, Gg, Gg, Gd, Aa, Aa
Ha, Aa^Fpa, Ha, Khr, Gg, Rp, Hh, Ww, Ww, Gs^Fmw, Gg, Gg, Hh, Rp, Re^Gvs, Gs^Fmw, Re^Gvs, Hh, Gs^Fmw, Ww, Ww, Ww, Gg, Gg, Aa^Vha, Gd, Aa
Ha, Aa, Gd, Gg, Gg, Rp, Rp, Ww, Ww, Ww, Gg, Hh, Mm, Rp, Re^Gvs, Re^Gvs, Re^Gvs, Gg, Wwf, Ww, Wwf, Gg, Gg, Gs^Fp, Chr, Aa, Ha
Ms, Aa, Aa, Gg, Aa^Vha, Gs^Fp, Wwf, Wwf, Wwr, Ss^Vhs, Gg, Gs^Fmw, Gg^Wm, Rp, Gg, Re^Gvs, Re^Gvs, Gg^Vh, Gg, Wwf, Wwf, Gs^Fp, Gg, Hh, Gd, Aa^Uf, Ha
Aa^Fpa, Aa, Aa, Ai, Ai, Wwf, Wwf, Wwf, Gg, Gs^Fp, Re^Gvs, Re^Gvs, Re^Gvs, Rp, Gg^Efm, Re^Gvs, Ww, Hh, Ww, Ww, Ww, Ai, Gg, Gg, Gd, Aa, Ha
Aa^Fpa, Gd, Ww, Ww, Ww, Ww, Ww, Rp, Rp, Ww, Ww, Re^Gvs, Re^Gvs, Rp, Gg^Vh, Gs^Fp, Ww, Ww, Ww, Ww, Wwf, Gg, Gg, Gg, Hh, Gd, Ms
Aa^Fpa, Aa^Fpa, Ww, Ww, Hh, Gg, Gs^Fp, Re^Uf, Rp, Hh, Rp, Re^Gvs, Rp, Rp, Rp, Gg^Efm, Ww^Bw/, Ww^Bw\, Rp, Aa^Uf, Gg, Gg, Aa^Vea, Gg, Gd, Gd, Ha
Ai, Ww, Ww, Ai, Ha, Mm, Gd, Gg, Gg, Rp, Hh, Cv, Cv, Cv, Cv, Cv, Ww, Ww, Gs^Fp, Rp, Gg, Gg, Aa, Aa, Aa, Gd, Ha
Ai, Ai, Ww, Ww, Aa, Aa^Fpa, Aa, Aa^Uf, Aa, Aa^Vha, Aa, Aa, Aa^Fpa, 2 Kv, Aa, Ww, Ww, Ww, Ww, Rp, Gd, Re^Uf, Re^Uf, Ha, Aa^Fpa, Aa^Fpa, Aa^Fpa
Ai, Aa^Fpa, Aa^Fpa, Aa^Fpa, Aa^Fpa, Aa^Fpa, Aa^Fpa, Ha, Ms, Ms, Aa^Fpa, Aa^Fpa, Aa^Fpa, Aa^Fpa, Aa^Fpa, Aa^Fpa, Ai, Ai, Ww, Rp, Aa^Fpa, Aa^Uf, Aa^Fpa, Aa^Fpa, Aa^Fpa, Aa^Uf, Aa^Fpa
