border_size=1
usage=map

Uue^Ii, Uue^Ii, Uue^Ii, Uue^Ii, Uue^Ii, Uue^Ii, Xue, Xue, Xue, Xue, Xue, Xue, Wwg, Wwg, Wwg, Wwg, Wwg, Wwg, Xol, Xos, Xol, Xos, Xos, Xos, Xos, Xol, Xos, Xos, Xol, Xol, Xol, Xos, Xol, Xos, Xos, Xol, Xol, Xos, Xos, Xos, Xos, Xol, Xol, Xos, Xol, Xol, Xol, Xol, Xos, Xol, Xos, Xos, Xos, Xos, Xos, Xos, Xos, Xos, Xos, Xos, Xos, Xos, Xos, Xos, Xos, Xos, Xuce, Xuce, Xuce, Xuce, Xuce, Xuce, Xuce, Xuce, Xuce, Xuce, Xuce, Xuce, Xuce, Xuce, Xuce, Xuce
Uue^Ii, Uue^Ii, Uue^Ii, Uue^Ii, 4 Uue, Uue, 5 Uue, Uue^Vu, Xue, Xue, Uue^Uf, Uue^Uf, Wwg, Wwg, Wwg, Wwg, Wwg, Xol, Cud, Cud, Cud, Xol, Xol, Urb, Urb, Xos, Urb, Cud, Cud, Xol, Cud, Rb, Urb, Urb, Urb^Vud, Xol, Xol, Xos, Xos, Xos, Urb, Xol, Xol, 1 Kud, Urb, Xol, Xol, Xol, Cud, Xos, Xol, Xos, Xol, Xol, Urb, Xos, Rb, Xos, Xos, Xos, Urb, Xos, Xos, Xos, Uue^Uf, Xuce, Xuce, Xuce, Qxe, Xuce, Uue^Uf, Uue^Uf, Wwf, Xuce, Wwf, Xuce, Uue, Xuce, Rb, Xuce, Xuce, Xuce
Xue, Uue^Ii, 2 Uue^Ii, 3 Re, Re, Re, Re, Xue, Uue^Em, Xue, Xue, Uue^Uf, Wwg, Wwg, Wwg, Wwg, Wwf, Rb^Fetd, Urb, Urb, Urb, Urb, Urb^Vud, Xol, Xos, Urb^Vud, Urb, Cud, Rb, Cud, Urb^Vud, Rb, Rb, Rb, Co^Edb, Co^Edb, Co^Edb, Xol, Xol, Urb^Vhc, Urb, Urb, Urb, Xos, Xol, Xol, Cud, Cud^Vhc, Xos, Urb, Urb, Xol, Xol, Urb^Vud, Urb, Urb, Xol, Urb, Urb^Dr, Urb, Xos, Urb, Urb^Em, Cud, Re, Uue, Xuce, Qxe, Uue^Dr, Re^Dr, Uue, Wwf, Uue^Dr, Wwf, Uue^Uf, Rb, Rb, Rb, Xuce, Cud, Xuce, Xuce
Xue, Uue^Ii, Uue, Uue, Uue, Re, Re, Re, Uue, Uue, Uue^Vud, Wog, Wog, Wwg, Wwg, Uu^Uf, Uu^Vud, Wwf, Urb^Dr, Urb, Rb, Urb^Dr, Urb, Urb, Xol, Urb, Rb, Rb, Rb, Cud, Rb^Es, Urb, Urb, Urb, Urb, Co^Edb, Co^Edb, Co^Edb, Co^Edb, Xol, Xos, Urb, Urb, Urb, Cud, Xol, Xos, Urb, Urb, Xol, Xol, Urb^Vud, Cud, Xol, Xol, Urb^Dr, Urb, Xol, Xol, Xol, Cud, Xos, Urb, Xos, Xos, Re^Vu, Qxe, Qxe, Re, Uue, Uue^Vu, Re, Xuce, Uue, Re, Uue, Rb, Uue^Uf, Uue, Xuce, Xuce, Xuce
Xue, Xue, Xue, Xue, Xue, Re, Re, Re, Re, Re^Em, Re, Wog, Wog, Wog, Wwg, Wwg, Wwg, Wwf, Wog, Wog, Urb, Rb^Fetd, Urb, Urb^Dr, Xol, Wwf, Rb, Urb, Urb, Rb, Urb^Dr, Rb, Cud, Urb, Rb, Co^Edb, Co^Edb, Co^Edb, Co^Edb, Urb, Urb, Xos, Xos, Cud, Urb, Urb, Rb, Xol, Xol, Urb^Vud, Cud, Xos, Xol, Urb, Urb, Xol, Xol, Co, Co, Co, Co, Xos, Xos, Urb, Urb, Xos, Xos, Uue^Uf, Uue, Uue, Uue, Re, Wwf, Uue^Uf, Uue, Rb, Uue^Vu, Qxe, Uue^Uf, Uue^Dr, Xuce, Xuce
Xue, Xue, Xue, Uue^Vu, Uue^Em, Re, Rb, Uue^Uf, Re, Re, Re, Wog^Bw\r, Wog, Wog, Wwg, Wwg, Wwg, Wwg, Wog, Urb^Vud, Urb^Dr, Urb, Urb, Urb, Urb, Urb, Urb, Urb^Vud, Urb, Rb^Fetd, Rb, Rb, Cud, Urb^Vud, Rb^Es, Urb, Co^Edb, Urb, Rb, Urb^Vud, Urb, Urb, Urb, Xol, Xol, Urb, Rb, Urb^Vhc, Urb, Xos, Xol, Urb, Urb, Xol, Xos, Urb, Urb, Xol, Xol, Co^Vu, Co^Vu, Co, Xos, Cud, Urb, Rb, Xos, Xos, Wwf, Uue^Uf, Re, Re, Xuce, Wwf, Uue, Rb, Rb, Uue, Uue^Dr, Wwf, Xuce, Xuce
Xue, Xue, Xue, Uue^Uf, Uue^Uf, Uue, Rb, Rb, Re, Re^Em, Re^Vud, Wog, Wog, Wwg, Uue^Uf, Wwg, Wwg, Wwg, Wwg^Bw/r, Urb, Urb, Urb, Urb^Vud, Cud, Xol, Urb, Rb, Rb^Es, Rb, Cud, Rb, Cud, Cud, Cud, Urb, Wwf, Urb, Urb, Urb, Rb, Cud, Rb^Fetd, Co^Edb, Co^Edb, Co^Edb, Xol, Xol, Urb, Urb, Urb, Urb, Xol, Xos, Urb, Urb, Cud, Urb^Vud, Urb, Urb, Xol, Xol, Xos, Urb, Urb, Xos, Xos, Cud, Xos, Xos, Wwf, Re, Uue, Uue, Re, Rb, Rb, Uue, Uue, Wwf, Wwf, Xuce, Xuce
Xue, Xue, Xue, Xue, Uue^Uf, Uue, Rb, Rb, Xue, Xue, Xue, Re^Em, Wog, Wog, Wwg, Re, Re, Wwg, Wwf, Urb^Dr, Urb, Cud, Cud, Cud, Xol, Uh, Urb, Urb, Rb, Cud, Cud, Rb, Rb, Rb, Rb, Urb^Dr, Rb^Fetd, Urb, Urb, Cud, Rb, Rb, Urb, Urb, Urb, Co^Edb, Co^Edb, Xol, Xol, Urb^Vhc, Urb, Urb, Urb^Vhc, Xol, Xol, Urb, Urb, Cud, Urb, Urb, Cud, Urb, Xos, Xos, Urb, Urb, Urb, Rb, Wwf, Wwf^Dr, Xos, Uue^Dr, Re, Uue^Uf, Rb, Uue, Uue, Uue^Uf, Wwf, Xuce, Xuce, Xuce
Xue, Xue, Uue^Vu, Uue^Uf, Rb, Rb^Em, Uue, Uue^Vu, Xue, Xue, Xue, Xue, Wwg, Wwg, Wwg, Uue^Vud, Re, Wwf, Wwf, Wwf, Xos, Cud, Xol, Xol, Xuce, Uh^Em, Uh, Urb, Uu, Urb, Uh, Cud, Urb, Urb, Rb, Rb, Urb^Dr, Urb, Rb, Cud, Rb, Cud, Urb, Xos, Urb, Co^Edb, Co^Edb, Co^Edb, Urb^Vud, Xos, Xos, Urb, Rb, Urb, Urb, Xos, Xol, Urb, Urb, Urb^Vud, Cud, Cud, Urb^Em, Urb, Xol, Rb^Vo, Wwf, Urb^Em, Urb, Wwf, Rb^Em, Xos, Xos, Xos, Rb, Xuce, Xuce, Xuce, Xuce, Xuce, Xuce, Xuce
Xue, Xue, Uue^Uf, Uue^Em, Rb^Em, Uue^Em, Xue, Xue, Xue, Uue^Em, Uue^Em, Xue, Wwf, Wwg, Wwg, Re, Wwg, Wwf, Wwf, Wwf, Sm, Xos, Xos, Xuce, Sm, Xuce, Xuce, Uu, Uh, Urb, Uu, Urb, Urb, Urb, Rb^Fetd, Rb, Rb, Rb^Es, Urb, Rb, Rb, Cud, Urb^Vud, Urb, Rb^Fetd, Urb, Co^Edb, Co^Edb, Urb, Urb, Wwf, Xol, Xol, Urb, Urb^Vhc, Urb, Urb, Xol, Xos, Cud, Cud, Urb, Xos, Xos, Cud, Xos, Xol, Wwf, Wwg, Urb, Urb, Xos, Rb^Ftr, Md, Rb^Ftr, Rb, Rb^Ftr, Rb^Vo, Rb^Uf, Xuce, Ur, Xuce
Xue, Xue, Xue, Uue, Rb, Uue^Uf, Uue^Em, Rb^Vu, Xue, Xue, Xue, Xue, Wwf, Wwg, Uue^Uf, Wwg, Wwf, Wwg, Wwf, Wwf, Rb, Sm^Em, Rb^Uf, Sm, Sm^Vhs, Sm, Sm, Xuce, Xuce, Uu^Vu, Uh, Wwf, Uu^Em, Uu, Uh, Rb, Urb, Urb, Urb, Rb^Fetd, Rb, Cud, Cud, Urb, Rb, Rb, Urb, Urb, Urb, Urb, Rb^Dr, Urb, Urb, Xos, Xos, Urb, Urb, Urb, Cud, Cud, Urb, Urb, Xos, Urb, Xos, Urb, Urb^Dr, Xol, Xos, Wwg, Rb^Ftr, Rb^Em, Rb^Uf, Rb^Ftr, Md, Rb^Vo, Rb, Rb^Ftr, Md, Ur^Em, Xu, Xu
Xue, Xue, Xue, Uue^Em, Uue, Rb, Rb, Rb, Uue, Wwf, Wwf, Wwf, Wwf, Uue^Em, Uue^Em, Wwf, Wwg, Wwf, Sm^Vhs, Rb, Rb, Sm, Sm^Em, Rb, Rb, Sm^Fetd, Rb, Sm, Rb^Uf, Xuce, Xuce, Xuce, Xuce, Uh, Xuce, Uh, Uu^Vu, Urb, Urb, Cud, Rb, Rb, Rb, Rb, Urb^Vud, Rb, Rb, Rb^Fetd, Cud, Rb, Urb, Urb, Ql, Ql, Ql, Xos, Xos, Urb, Cud, Urb, Urb, Urb, Xos, Urb, Xos, Xos, Xos, Urb, Urb, Xos, Md, Rb^Ftr, Rb, Rb^Em, Rb, Rb^Ftr, Rb, Rb^Ftr, Rb, Rb^Uf, Xu, Xu
Xue, Xue, Xue, Uue^Vu, Uue, Uue, Uue, Rb, Uue^Uf, Wwf, Wwf, Wwf, Wwg, Wwf, Wwf, Uue^Uf, Wwg, Wwg, Sm^Em, Sm, Rb, Rb, Rb, Co, Sm^Em, Rb^Em, Sm, Rb^Em, Sm, Rb^Em, Rb^Uf, Uh, Uu, Xuce, Sm, Xuce, Xuce, Uu, Uu, Cud, Cud, Cud, Rb, Urb, Rb^Fetd, Urb, Rb^Es, Rb, Rb, Cud, Cud, Urb, Ql, Rb^Ecf, Rb, Ql, Urb, Xol, Xol, Urb, Urb, Urb^Vhc, Urb, Urb^Dr, Xol, Cud, Xol, Xol, Cud, Xos, Rb^Ftr, Rb^Ftr, Md^Ftr, Rb^Ftr, Rb, Rb, Wwf, Rb^Em, Rb^Ftr, Ur, Xu, Xu
Xue, Uue^Uf, Uue^Uf, Xue, Xue, Xue, Uue^Vu, Rb, Wwf, Wwf, Wwf, Wwg, Wwg, Wwg, Wwg, Wwg, Wwg, Wwg, Rb, Sm, Rb^Uf, Rb^Em, Rb, Sm, Rb^Em, Rb^Uf, Sm^Em, Rb, Sm, Sm, Sm^Em, Rb^Em, Co, Sm^Em, Rb^Uf, Sm^Em, Xuce, Uh, Uh, Uu, Cud, Urb, Urb, Urb, Urb^Vud, Rb, Urb^Dr, Rb, Cud, Rb, Cud, Urb, Rb, Ql, Rb^Es, Ql, Urb, Urb^Vhc, Urb, Xol, Rb, Urb, Xos, Xol, Urb, Urb, Rb, Urb, Xos, Xos, Xu, Xu, Rb^Ftr, Rb, Rb^Ftr, Rb^Ftr, Xu, Rb^Ftr, Rb^Ftr, Xu, Xu, Xu
Wog, Uue^Uf, Uue^Em, Xue, Uue^Em, Xue, Wwg, Wwf, Wwf, Wwf, Wog, Wwg, Wwg, Wwg, Wog, Wog, Sm, Sm, Rb, Sm, Sm, Sm^Em, Rb^Uf, Rb, Sm^Em, Rb^Uf, Sm, Sm, Sm^Vhs, Sm, Rb^Uf, Rb, Sm, Rb, Sm^Em, Sm, Uh, Xuce, Uh, Uu^Vu, Uu, Cud, Uu, Urb, Urb, Urb, Urb, Rb, Cud, Rb, Rb^Es, Rb, Uh, Rb, Rb, Ql, Urb, Urb, Urb^Dr, Urb, Rb, Urb, Xos, Xos, Xos, Urb^Vud, Xos, Xos, Xu, Xu, Xu, Rb^Uf, Rb, Rb, Rb^Em, Xu, Rb^Uf, Xu, Rb^Ftr, Ur^Em, Xu, Xu
Wog, Wwg, Uue^Uf, Uue^Em, Wwg, Wwg, Wwg, Wwg, Wwf, Wwf, Wog, Wog, Wog, Wog, Uu, Uu^Uf, Uu^Uf, Sm, Rb^Em, Rb, Rb^Em, Sm^Vhs, Rb, Sm^Fetd, Sm, Rb^Em, Rb, Rb, Rb, Rb, Sm, Rb^Em, Sm^Fetd, Sm^Em, Sm, Sm, Rb, Xuce, Xuce, Xuce, Xuce, Uh, Xuce, Uu^Em, Wwf, Uu, Urb, Rb, Qlf, Cud, Rb, Uh, Uh, Wwf, Uh, Rb^Es, Rb, Rb, Urb, Urb, Urb, Urb, Ur^Em, Xu, Xu, Xos, Xu, Xu, Xu, Xu, Xu, Rb^Em, Wwg^Vhs, Xu, Wwf, Wwf, Wwf, Wwf, Wwf, Wwf, Rb^Uf, Xu
Wog, Wwg, Wwg, Wwg, Wwg, Wwg, Wwg, Wwg, Wwg, Wwf, Uu^Uf, Uu^Uf, Uu^Uf, Wog, Uu^Em, Uu, Rb^Es, Sm, Sm, Rb^Uf, Sm, Rb, Sm, Sm^Em, Co, Rb, Rb^Uf, Sm^Em, Sm, Rb^Em, Sm, Rb, Rb, Sm^Em, Rb^Uf, Sm^Em, Rb, Uh, Sm, Sm, Sm, Xuce, Sm^Emf, Xuce, Xuce, Uu^Em, Uh, Rb^Fetd, Ql, Ql, Ql, Rb^Es, Uh, Uh, Cud, Rb, Cud, Rb, Cud, Cud, Cud, Rb, Rb, Uh, Rb, Xu, Ur, Rb^Uf, Rb^Em, Xu, Rb^Uf, Wwg, Wwg, Wwg, Wwf, Wwg, Wwg, Wwg, Wwg, Rb^Uf, Xu, Xu
Wog, Wog, Wwg, Wwg, Wwg, Wwg, Wwg, Wwg, Wwf, Wwf, Rb, Uu, Rb, Uu, Rb, Rb, Uh, Rb, Uu^Em, Sm, Sm, Sm, Sm, Rb^Uf, Rb, Rb, Rb^Em, Rb, Sm^Vhs, Sm^Em, Rb^Uf, Rb, Rb^Uf, Sm^Vhs, Rb^Uf, Rb^Em, Rb, Sm, Sm, Sm^Em, Sm, Sm, Sm^Em, Sm^Emf, Sm^Emf, Xuce, Xuce, Uu^Vu, Uu, Ql, Ql, Rb, Uh, Cud, Rb, Rb, Urb^Vhc, Cud, Rb^Vhc, Cud, Cud, Urb, Rb, Rb, Ur^Em, Rb, Rb^Dr, Ur, Ur, Ur, Wwf, Wwg, Wwg, Wwg, Wwg, Wwf, Wwg, Wwg, Wwg, Wwf, Rb^Uf, Xu
Wog, Wog, Wog^Bw\r, Wwg, Wwg, Wwg, Xu, Uu^Uf, Uu^Uf, Rb, Uu^Em, Rb, Uh, Rb, Uh, Rb, Xu, Uh^Br\, Uu^Br\, Uu^Br/, Uu^Uf, Uu^Uf, Sm, Sm, Rb, Sm, Sm^Fetd, Sm, Sm, Rb, Sm, Sm^Em, Rb, Rb, Rb^Em, Rb, Rb, Sm^Vhs, Sm, Co, Rb^Em, Rb^Uf, Rb^Uf, Sm, Sm, Xuce, Xuce, Uh, Uu^Em, Ql, Rb, Rb^Em, Uh, Cud, Rb^Es, Urb, Cud, Cud, Rb, Cud, Cud, Cud, Urb, Xu, Xu, Ur, Xu, Ur^Em, Xu, Ur^Uf, Wwf, Wwf, Wwf, Wwg, Rb^Uf, Wwg, Rb^Ecf, Wwf, Wwf, Wwg, Xu, Xu
Wog, Wwg, Wwg, Urb^Dr, Wwg, Xu, Cud, Xu, Uu^Uf, Uu, Xu, Xu, Xu, Uh, Xu, Uh, Xu, Uh, Uh, Rb^Br\, Uu^Br\, Uu^Uf, Sm, Sm^Vhs, Sm^Em, Rb^Em, Sm^Em, Sm, Sm^Em, Rb, Sm^Em, Sm^Fetd, Co, Rb, Sm^Em, Sm, Rb^Uf, Rb, Rb, Rb^Em, Sm^Fetd, Sm, Rb, Sm^Em, Sm, Sm, Xuce, Uh, Ql, Ql, Urb^Vud, Urb, Uh, Cud, Cud, Urb, Urb, Cud, Rb, Rb^Es, Rb, Urb^Vhc, Urb, Xu, Xu, Xu, Xu, Ur^Em, Rb, Xu, Xu, Wwf, Qlf, Wwg, Wwg, Rb^Dr, Ur, Ur^Dr, Ur^Em, Wwg, Wwg, Xu
Wog, Wwg, Urb^Br\, Urb, Uh, Xu, Uh, Xu, Xu, Xu, Uu^Vu, Uh, Uu^Em, Xu, Uh, Xu, Uh, Uh, Uh^Br/, Rb^Br/, Xu, Uu^Br\, Ur^Br|, Sm, Sm, Rb^Uf, Sm, Sm, Uh, Rb^Uf, Rb^Em, Sm, Rb^Em, Rb^Uf, Sm^Em, Sm, Sm, Sm^Em, Sm^Em, Rb^Uf, Sm^Em, Sm, Rb, Sm^Em, Sm, Qlf, Ql, Ql, Ql, Ql, Qlf, Urb^Ecf, Ql, Uh, Cud, Urb^Vhc, Urb, Cud, Urb, Urb, Rb, Urb, Urb, Xu, Qlf, Qlf, Xu, Xu, Xu, Ur^Em, Uu, Xu, Qlf, Wwg, Qlf, Ur, Mv, Ur, Ur^Vd, Wwg, Qlf, Qlf
Xos, Urb^Br/, Urb, Ur^Br\, Ur^Br\, Uu, Uu^Vu, Xu, Xu, Xu, Uh, Uu, Uh, Rb, Rb^Br/, Rb^Br\, Rb^Br/, Rb^Br/, Uh, Xu, Uh, Uu, Ur^Br|, Uu^Uf, Xu, Sm, Xu, Ur, Uh, Rb, Sm, Sm, Rb, Sm, Sm, Rb, Sm^Em, Sm, Rb, Rb, Sm^Vhs, Sm, Sm, Rb^Uf, Sm, Qlf, Ql, Ql, Ql, Ql, Ql, Ql^Bcx|, Ql, Ql, Cud, Urb, Urb^Vhc, Urb, Cud, Urb^Vhc, Cud, Urb, Urb, Qlf^Bcx\, Qlf^Bcx\, Qlf, Qlf, Qlf, Xu, Xu, Uh, Xu, Xu, Qlf, Qlf, Md, Md, Md, Qlf, Ur^Ecf, Qlf, Qlf
Xos, Cud^Br|, Cud^Vud, Xos, Xol, Ur^Br\, Ur^Br\, Ur, Xu, Xu, Xu, Xu, Uh, Uu, Rb^Br|, Uh, Uu^Vu, Uu^Em, Xu, Xu, Uh, Uu, Ur^Br\, Uu^Em, Cud, Xu, Wwf, Xu, Xu, Sm, Sm, Sm^Em, Sm^Em, Sm, Sm^Vhs, Sm, Sm, Sm^Em, Sm, Sm, Sm, Sm, Sm^Fetd, Rb, Urb^Es, Urb, Urb^Em, Ql, Ql, Ql, Ql, Ql^Bcx|, Ql, Ql, Ql, Cud, Cud, Cud, Cud, Cud, Cud, Cud, Cud, Qlf, Qlf, Qlf^Bcx\, Qlf^Bcx\, Qlf, Qlf, Xu, Xu, Xu, Xu, Xu, Qlf, Ur, Ur, Qlf, Qlf, Qlf, Qlf, Qlf
Xos, Cud^Br|, Cud^Br\, Cud, Cud, Xol, Xos, Ur^Br\, Ur^Br\, Uh, Wwg, Xu, Uh^Br/, Cud^Br/, Uh, Xu, Xu, Xu, Xu, Wwf, Uu, Rb, Uh, Ur^Br\, Ur, Ur^Em, Ur^Br/, Uh, Uu^Vu, Xu, Uh, Uu^Uf, Uu, Uu, Uu^Uf, Uu^Uf, Uu^Em, Sm^Em, Uu^Uf, Sm, Uh, Sm, Qlf, Qlf, Ql, Urb, Ql^Bcx\, Ql^Bcx\, Urb, Urb^Vd, Ql, Ql^Bcx|, Ql, Cud^Ecf, Ql, Cud, Ql, Cud, Ql, Cud, Cud, Cud, Cud^Vhcr, Qlf, Qlf, Qlf, Qlf, Qlf, Qlf^Bcx\, Xu, Qlf, Xu, Xu, Xu, Qlf, Ur, Qlf, Qlf, Ch, Kh, Qlf, Qlf
Xos, Xos, Cud, Cud^Br\, Cud^Br\, Cud^Vud, Cud, Xol, Xol, Uh^Br\, Ur^Br\, Ur^Br/, Ur, Xu, Xu, Xu, Xu, Xu, Xu, Uu^Vu, Rb, Rb, Uu, Uu^Br|, Uu^Br\, Uu^Br/, Cud, Ur^Br\, Ur^Br\, Xu, Xu, Uh^Em, Xu, Uh, Xu, Uh, Wwf, Uu, Uh, Uh, Xu, Uh, Xu, Ql, Ql, Ql, Ql, Urb^Dr, Urb, Cud, Urb, Ql^Bcx|, Ql, Ql, Ql, Ql, Ql, Ql, Cud^Ecf, Ql, Ql, Cud, Ql, Qlf, Qlf, Qlf, Qlf, Qlf, Qlf, Qlf^Bcx\, Qlf^Bcx\, Qlf, Xu, Ur^Dr, Ur, Ur^Em, Uh, Qlf, Qlf, Ch, Qlf, Qlf
Xos, Cud, Qxua, Qxua, Cud^Br|, Cud^Br\, Cud^Br\, Cud, Urb, Xos, Xol, Uh, Urb, Xu, Xu, Xu, Xu, Cud, Cud, Xu, Uh^Em, Rb, Uh, Uh, Uh, Uu, Qxu, Uh, Ur^Em, Ur^Br\, Ur^Br\, Xu, Cud, Xu, Ur^Vud, Xu, Xu, Xu, Xu, Xu, Uue^Vo, Xu, Ql, Ql, Urb^Vd, Ql, Ql, Ql^Bcx/, Ql, Cud, Urb, Urb, Urb, Cud, Ql, Ql, Ql^Bcx/, Ql, Ql, Ql, Ql, Ql, Ql, Ql, Ql, Qlf, Qlf, Xu, Qlf, Qlf, Qlf, Qlf^Bcx\, Qlf^Bcx\, Ur^Ecf, Uu, Uu, Qlf, Qlf, Qlf, Qlf^Bcx|, Qlf, Qlf
Xos, Cud, Qxua, Qxua, Cud^Br|, Xol, Xol, Cud^Br\, Urb^Br\, Wwf, Cud, Xol, Xos, Uh, Urb, Ur, Xu, Xu, Uh, Xu, Xu, Uh, Xu, Wwf, Xu, Qxu, Qxu, Qxu, Ur, Ur, Cud, Ur^Br/, Rb, Ur, Cud, Re, Xos, Uue, Uue, Uue, Uue, Uue^Em, Ql, Uh, Urb^Es, Urb, Ql, Ql, Ql, Urb^Vd, Urb, Urb^Es, Urb, Urb, Urb, Urb^Vd, Ql, Ql, Cud, Ql, Ql, Cud^Ecf, Ql, Ql, Ql, Ql, Ql, Xu, Xu, Qlf, Qlf, Qlf, Qlf, Urb, Uh, Qlf, Rr, Qlf, Qlf, Urb, Uu, Qlf
Xos, Xos, Xos, Qxua, Cud^Br\, Cud^Vud, Cud, Xos, Xos, Cud^Br\, Cud^Br\, Cud^Vud, Urb, Xol, Xol, Uu^Em, Uu, Uu^Vu, Uu^Em, Xu, Uh, Xu, Uu^Vu, Xu, Uh, Wwf, Uh, Qxu, Cud, Ur^Em, Rb, Rb, Cud, Re, Re, Re, Xos, Urb, Co, Co, Urb^Em, Ql, Urb^Vud, Uh, Urb, Urb, Ql, Ql, Ql, Cud, Ql, Ql, Ql, Urb^Dr, Urb, Urb, Urb, Urb, Ql, Ql, Cud, Ql, Ql, Ql, Ql, Ql, Ql, Ql, Qlf, Qlf, Qlf, Qlf, Urb, Urb, Urb^Vhc, Qlf, Qlf, Qlf, Urb, Urb, Urb, Xu
Xos, Cud, Cud, Xos, Xos, Cud^Br\, Cud^Br\, Cud, Cud, Xos, Xos, Urb^Br\, Cud^Br\, Cud, Urb, Urb^Dr, Urb^Dr, Rb, Rb, Rb, Uh, Uh, Rb, Uu^Em, Uu, Uu, Qxu, Qxu, Rb, Rb, Cud, Re, Rb, Rb, Ur^Vud, Cud, Rb, Urb, Co, Urb, Urb^Dr, Ql, Ql, Urb, Urb, Cud, Ql, Ql, Cud^Ecf, Ql, Cud, Ql, Ql, Ql, Urb^Vd, Urb, Urb, Urb, Cud^Ecf, Ql, Urb^Vud, Cud, Ql, Ql, Ql, Cud^Ecf, Ql, Ql, Qlf, Qlf, Ql, Qlf, Qlf, Xu, Urb, Urb, Qlf^Bcx/, Qlf^Bcx/, Qlf, Urb^Vhc, Ur, Xu
Xos, Cud, Xos, Xos, Cud, Xos, Xos, Cud^Br\, Cud^Br\, Xos, Cud, Xol, Xol, Cud^Br\, Urb^Br\, Urb, Cud, Xos, Xol, Rb, Rb, Rb, Rb, Uh, Rb, Qxu, Qxu^Bh/, Rb, Rb, Re, Re, Re, Rb, Ur, Xos, Xos, Rb, Urb, Co, Urb, Urb^Es, Urb, Urb^Dr, Rb, Rb, Cud^Ecf, Cud, Ql, Ql, Ql, Ql, Cud, Ql, Ql, Ql, Ql, Ql, Cud, Cud, Cud, Urb, Cud, Urb, Ql, Ql, Cud, Cud, Ql, Qlf, Ql, Ql, Ql, Ql, Xu, Ur, Urb^Dr, Qlf, Qlf, Qlf, Urb, Xu, Xu
Xos, Xos, Xos, Cud, Cud, Cud, Xos, Cud, Xos, Cud^Br\, Cud^Br\, Cud, Ur, Xos, Xos, Cud^Br\, Cud^Br\, Cud^Vud, Urb, Xos, Xol, Uu^Vu, Uu, Rb, Uu, Rb, Qxu, Qxu, Uu, Rb, Cud, Rb, Wwf, Cud, Xos, Uue, Urb, Urb^Vo, Co, Urb, Urb, Ql, Urb, Urb, Rb, Urb, Urb, Ql, Ur^Vu, Ql, Ur, Ql, Ur, Rb, Ql, Ql, Ql, Urb^Vud, Urb, Urb^Vud, Ql, Ql, Ql, Ql^Bh\, Urb^Vd, Urb, Urb, Ql, Ql, Ql, Cud^Ecf, Ql, Ql, Ql, Ql, Urb^Vhcr, Qlf, Qlf, Ur^Dr, Urb, Xu, Xu
Xos, Xos, Xos, Xos, Xos, Xos, Cud, Cud, Cud, Xos, Urb, Urb^Br\, Urb^Br\, Urb^Dr, Urb, Xos, Xos, Urb^Br\, Cud^Br\, Cud, Cud, Xol, Xos, Rb, Uu^Em, Uh, Qxu, Uh, Uh^Em, Ur, Ur, Ur^Vud, Ur, Xos, Uue, Uue, Rb, Rb, Urb, Co, Ql, Ql, Urb, Urb^Vud, Urb, Urb^Es, Uh, Ql^Bh/, Ql, Rb, Ur^Dr, Ur, Ur^Vu, Rb, Ql^Bh\, Ql, Ur, Urb, Cud^Ecf, Urb, Ql, Ql, Cud^Ecf, Ql, Ql, Ql, Ql, Urb, Ql^Bh\, Ql, Ql, Ql, Cud^Ecf, Ql, Ql, Qlf, Ql, Qlf, Urb, Urb, Xu, Xu
Xos, Xos, Xos, 6 Kud, Cud, Xos, Xos, Cud, Xos, Xos, Urb, Urb^Dr, Xos, Ur^Br\, Urb^Br\, Urb^Vud, Rb^Dr, Xos, Xos, Cud^Br\, Cud^Br\, Xos, Cud, Xos, Xos, Uh, Uh, Qxu, Uu, Uu, Uu, Ur, Cud, Xos, Xos, Uue, Rb, Urb, Urb^Vo, Ql, Uh, Uh, Uh, Uh, Uh, Uh, Uh, Ql, Ql, Ql, Ql, Ql, Ql, Ql, Ql, Rb, Ur, Ql, Ql, Ql, Ql, Ql, Ql, Ql, Ql, Ql, Ql, Ql, Urb, Urb^Dr, Ql, Ql, Ql, Ql, Ql, Qlf, Ql^Bcx/, Ql^Bcx/, Ql, Urb^Vhc, Xu, Xu
Xos, Urb, Urb, Xos, Xos, Xos, Xol, Xos, Xos, Cud, Cud, Urb, Urb, Urb^Dr, Urb, Urb^Br\, Rb^Br\, Uh, Xos, Cud^Br|, Qxua, Cud^Br\, Cud^Br\, Cud, Cud, Xos, Xos, Qxu, Qxu, Ur, Rb, Qxu, Qxu, Urb, Xos, Urb, Urb, Urb, Urb, Xos, Xos, Xos, Xos, Xos, Xos, Xos, Rb, Ql, Qlf, Ql, Qlf, Ql, Cud^Ecf, Ql, Ql, Ql, Ql, Ql^Bh\, Urb, Ql, Cud, Ql, Ql, Ql, Xos, Ql, Ql, Ql, Urb, Ql, Ql, Ql, Ql, Ql, Ql^Bcx/, Ql^Bcx/, Ql, Ql, Ql, Ql, Ql, Xu
Xos, Xos, Xos, Urb, Urb^Dr, Xol, Urb, Rb, Urb^Dr, Urb, Xol, Xos, Cud, Urb, Cud, Xos, Xos, Xos, Cud, Cud^Br|, Cud, Qxua, Qxua, Urb, Cud^Vhcr, Cud, Cud, Urb, Qxu^Bh/, Ur, Cud, Qxu, Qxu, Qxu^Bp|, Qxu, Xos, Cud, Cud, Urb, Xos, Xos, Cud, Urb, Xos, Urb^Dr, Xos, Qlf, Qlf^Bcx\, Qlf^Bcx\, Qlf, Qlf, Ql, Ql, Ql, Cud, Cud, Cud, Ql, Ql, Cud, Ql, Cud, Ql, Xos, Xos, Ql, Ql, Urb^Vd, Urb, Ql, Ql^Bh/, Urb, Urb^Vd, Urb, Ql^Bh\, Ql, Ql, Ql, Rr, Ql, Ql, Ql
Xos, Urb, Xol, Xol, Urb, Urb, Xos, Urb, Urb^Es, Urb, Rb, Xol, Urb, Cud, Xos, Cud, Cud, Xos, Xos, Cud^Br|, Cud, Cud, Cud, Qxua, Qxua, Cud, Qxua, Urb, Urb^Ecf, Qxu, Qxu, Qxu, Qxu, Qxu^Bp|, Qxu, Qxu, Qxu, Cud, Qxu, Qxu^Bp\, Qxu^Bp\, Xos, Urb, Urb, Urb, Urb, Qxu, Qlf, Qlf, Urb, Xos, Ql, Ql, Ql, Ql, Ql, Ql, Ql, Ql, Ql, Ql, Urb, Cud, Xos, Xos, Ql, Ql, Ql, Ql, Urb, Ql, Ql, Ql, Ql, Ql, Ql^Bh\, Ur, Ql, Ql, Ql, Ql, Ql
Xos, Xos, Urb^Es, Urb, Rb^Dr, Urb, Urb^Es, Urb, Xos, Urb^Ecf, Urb, Urb, Urb^Dr, Xos, Xos, Cud, Cud, Cud, Xos, Cud^Br|, Qxua, Cud, Cud^Vhcr, Cud, Qxua, Qxua, Qxua, Qxua, Qxua, Qxu, Qxu, Qxu, Qxu^Bp/, Qxu^Bp\, Qxu^Bp\, Qxu, Qxu, Qxu, Qxu^Bp/, Qxu, Qxu, Qxu^Bp\, Qxu, Qxu, Qxu, Qxu, Qxu, Qxu, Urb, Urb, Urb, Xos, Xos, Ql, Xos, Ql, Xos, Ql, Xos, Ql, Xos, Xos, Cud, Cud, Cud^Ecf, Urb, Ql, Ql, Ql, Ql^Bh|, Ql, Ql, Ql, Ql, Qlf, Ql, Ur^Ecf, Ur, Qlf, Ql, Ql, Ql
Xos, Rb, Urb^Es, Xos, Rb, Urb, Urb^Ecf, Urb^Dr, Rb, Urb, Xos, Urb^Es, Rb, Xos, Xos, Cud, Xos, Xos, Cud, Cud^Br|, Cud, Qxua, Qxua, Qxua, Qxua, Qxua, Qxua^Bp\, Qxua, Qxua, Qxu, Qxu^Bp/, Qxu^Bp/, Qxu, Qxu, Qxu, Qxu^Bp\, Qxu^Bp\, Qxu^Bp/, Qxu, Qxu^Bp\, Qxu^Bp\, Qxu, Qxu^Bp/, Qxu^Bp/, Qxu^Bp\, Qxu, Qxu^Bp/, Qxu^Bp/, Urb, Urb^Vud, Urb, Urb^Dr, Urb, Xos, Cud, Cud, Cud, Xos, Xos, Xos, Cud, Cud^Vud, Cud, Cud, Cud, Urb, Ql^Bh\, Ql, Urb, Urb, Ql, Ql, Ql, Qlf, Qlf, Ur^Dr, Ur, Ur^Dr, Qlf, Ql, Ql, Ql
Xos, Urb, Urb^Dr, Urb, Urb, Xos, Urb, Urb, Urb, Urb, Urb, Urb, Xos, Xos, Xos, Urb^Dr, Xos, Xos, Xos, Cud^Br|, Urb^Br\, Urb, Urb, Qxua, Urb, Qxua, Urb, Urb^Vud, Urb, Qxu^Bp/, Qxu, Qxu, Cud, Cud, Qxu, Qxu, Qxu, Qxu^Bp\, Qxu^Bp\, Qxu, Qxu, Qxu^Bp\, Qxu, Qxu, Qxu, Qxu^Bp/, Xos, Xos, Xos, Urb, Xos, Urb, Xos, Cud, Cud, Cud, Cud, Cud^Ecf, Cud, Cud, Cud, Cud, Cud, Xos, Xos, Urb, Ql, Ql^Bh\, Urb, Urb^Dr, Ql, Ql, Ql, Qlf, Ql, Qlf, Ql, Ql, Qlf, Qlf, Ql, Ql
Xos, Xos, Xos, Wwg, Rb, Urb^Es, Urb, Xos, Urb^Dr, Wwg, Xos, Xos, Urb, Urb, Xos, Urb, Urb, Urb, Ur, Ur, Uu^Br|, Uu, Ur, Urb, Urb^Dr, Urb, Ur, Urb, Xu, Qxu^Bp\, Qxu^Bp\, Qxu, Qxu, Qxu, Qxu^Bp/, Qxu^Bp/, Ur, Qxu, Qxu, Qxu^Bp\, Qxu^Bp\, Qxu, Qxu, Qxu, Xos, Xos, Urb, Urb^Vud, Urb, Xos, Xos, Xos, Cud^Vd, Xos, Xos, Cud^Vd, Cud, Cud, Cud, Cud, Xos, Xos, Xos, Cud, Xos, Ql, Ql, Ql, Ql, Ql, Ql, Ql, Ql, Qlf, Ql, Ql, Ql, Ql, Ql, Ql, Ql, Ql
Xos, Xos, Xos, Xos, Xos, Rb^Dr, Urb, Urb, Xos, Xos, Urb, Urb, Xos, Xos, Urb, Urb^Vu, Qxua, Qxua, Qxua, Uu^Br/, Ur, Uu, Uh, Xu, Xu, Ur, Xu, Xu, Xu, Xu, Xu, Qxu^Bp\, Qxu^Bp\, Qxu^Bp/, Xu, Xu, Xu, Ur^Dr, Ur, Qxu, Qxu, Qxu^Bp\, Urb, Urb, Urb^Dr, Urb, Xos, Urb, Xos, Urb, Xos, Xos, Xos, Cud, Cud, Cud, Xos, Cud, Xos, Xos, Xos, Xos, Cud^Vd, Cud, Xos, Ql, Ql, Ql, Ql, Ql, Rr, Ql, Ql, Ql, Ql, Ql, Ql, Ql, Ql, Ql, Ql, Ql
Xos, Xos, Xos, Xos, Xos, Xos, Xos, Xos, Xos, Xos, Xos, Xos, Xos, Xos, Qxua, Qxua, Qxua, Qxua, Qxua, Qxua, Xu, Xu, Xu, Xu, Xu, Xu, Xu, Xu, Xu, Xu, Xu, Xu, Xu, Xu, Xu, Xu, Xu, Xu, Xu, Xu, Xu, Xu, Xos, Xos, Xos, Xos, Xos, Xos, Xos, Xos, Xos, Xos, Xos, Xos, Xos, Xos, Xos, Xos, Xos, Xos, Xos, Xos, Xos, Xos, Xos, Ql, Ql, Ql, Ql, Ql, Ql, Ql, Ql, Ql, Ql, Ql, Ql, Ql, Ql, Ql, Ql, Ql
