border_size=1
usage=map

Gg, Gg, Gg, Gg, Gg, Gg, Gg, Gg, Gg, Gg, Gg, Gg, Gg, Ww, Gg, Gg, Gg, Gg, Gg, Gg, Gg, Gg, Gg, Gg, Gg, Gg, Re, Re, Gg, Gg, Gg, Gg, Gg, Gg, Gg, Gg, Gg, Gg, Gg, Gg, Gg, Gg, Gg, Gg, Gg, Gg
Rr, Gg, Gg, Gg, Gg, Gg, Gg, Gg, Gg, Gg, Gg, Gg, Wo, Wo, Wo, Gg, Gg, Gg, Gg, Gg, Gg, Gg, Gg, Gg, Gg, Re, Gg, Gg, Gg, Gg, Gg, Gg, Gg, Gg, Gg, Gg, Gg, Gg, Gg, Gg, Gg, Gg, Gg, Gg, Rr, Rr
Rr, Rr, Rr, Kh, Gg, Gg, Gg, Gg, Gg, Gg, Wo, Wo, Wo, Wo, Wo, Wo, Wo, Gg, Gg, Gg, Gg, Gg, Gg, Gg, Re, Re, Re, Gg, Gg, Gg, Gg, Gg, Gg, Gg, Gg, Gg, Gg, Gg, Gg, Gg, Gg, Gg, Gg, Gg, Rr, Gg
Rr, Rr, Rr, Ch, Ch, Gg, Gg, Gg, Wo, Wo, Wo, Wo, Ket, Ket, Ket, Wo, Wo, Wo, Wo, Gg, Gg, Gg, Gg, Gg, Re, Gg, Re, Gg, Gg, Gg, Gg, Gg, Gg, Gg, Gg, Gg, Gg, Gg, Gg, Gg, Gg, Gg, Rr, Rr, Gg, Gg
Gg, Rr, Ch, Ch, Ch, Kh, Wo, Wo, Wo, Wo, Ket, Ket, Gg, Gg, Gg, Ket, Ket, Wo, Wo, Wo, Wo, Gg, Gg, Gg, Re, Gg, Re, Gg, Gg, Gg, Gg, Gg, Gg, Gg, Gg, Gg, Gg, Gg, Gg, Gg, Gg, Gg, Rr, Gg, Gg, Gg
Gg, Gg, Kh, Ch, Wo^Bw\, Wo^Bw\, Wo^Bw\, Wo, Ket, Ket, Gg, Gg, Rrc, Rrc, Rrc, Gg, Gg, Ket, Ket, Wo, Wo, Wo, Wo^Bw/, Ce, Ket, Gg, Gg, Re, Re, Gg, Re, Gg, Gg, Gg, Gg, Gg, Gg, Gg, Gg, Gg, Gg, Gg, Rr, Gg, Gg, Gg
Gg, Gg, Wo, Wo, Wo, Wo^Bw\, Ce, Ce, Rr, Gg, Rrc, Rrc, Gg, Gg, Gg, Rrc, Rrc, Gg, Gg, Ket, Ce, Wo^Bw/, Wo, Wo, Wo, Gg, Gg, Gg, Gg, Re, Gg, Re, Re, Re, Re, Gg, Re, Gg, Gg, Gg, Rr, Rr, Gg, Gg, Gg, Gg
Wo, Wo, Wo, Wo, Ket, Ket, Gg, Rr, Rrc, Rrc, Gg, Gg, Gg, Gg, Gg, Gg, Gg, Rrc, Rrc, Rrc, Rrc^Vhc, Kh, Kh, Wo, Wo, Wo, Wo, Gg, Gg, Re, Gg, Gg, Gg, Gg, Gg, Re, Gg, Re, Rr, Rr, Gg, Gg, Gg, Gg, Ww, Gg
Wo, Wo, Ket, Ket, Gg, Gg, Rrc, Rrc, Gg, Rrc, Rrc, Gg, Gg, Gg, Gg, Gg, Rrc, Rrc, Kh, Rrc, Rrc, Gg, Gg, Kh, Kh, Wo, Wo, Wo, Wo^Bw/, Ce, Ket, Gg, Gg, Gg, Gg, Gg, Gg, Gg, Rr, Gg, Gg, Gg, Ww, Ww, Ww, Ww
Wo, Ket, Gg, Gg, Rrc, Rrc, Gg, Gg, Gg, Gg, Gg, Rrc, Rrc, Gg, Rrc, Rrc, Gg^Efm, Kh, Kh, Kh, Kh, Rrc, Rr, Ch, Ch, Kh, Ce, Wo^Bw/, Wo, Wo, Wo, Gg, Gg, Gg, Gg, Gg, Gg, Gg, Rr, Gg, Gg, Gg, Ww, Wo, Ww, Ww
Wo, Ket, Gg, Rrc, Rrc, Gg, Gg, Gg, Gg, Gg, Gg, Gg, Rrc, Rrc, Rrc, Rr^Vhc, Gg^Efm, Kh, Kh, Ch, Ch^Vhc, Gg^Efm, Rr, Ch, Rr, Rr, Rr^Vhc, Ket, Ket, Wo, Wo, Wo, Wo, Gg, Gg, Gg, Gg, Gg, Rr, Gg, Gg, Gg, Ww, Wo, Wo, Wo
Wo, Ket, Ket, Gg, Gg, Rrc, Rrc, Gg, Gg, Gg, Rrc, Rrc, Gg, Gg, Gg, Rr, Rr, Gg^Efm, Kh, Ch, Ch, Rr, Ch, Kh, Kh, Rr, Rrc, Gg^Efm, Re, Ket, Ket, Wo, Wo, Wo, Wo, Gg, Ch^Vhc, Gg, Ch, Gg, Ww^Vhs, Ww, Ww, Wo, Wo, Wo
Wo, Wo, Wo, Ket, Ket, Gg, Gg, Rrc, Rrc, Rrc, Gg, Gg, Gg, Gg, Gg, Gg, Gg, Rr, Rr, Ch, Gg^Efm, Ch^Vhc, Ch, Ch, Ch^Vhc, Kh, Gg^Efm, Rrc, Rrc, Gg, Gg, Ket, Ket, Wo, Wo, Wo, Wo^Bw/, Ch, Kh, Kh, Wo, Ww, Wo, Ww, Wo, Wo
Gg, Wo, Wo, Wo, Wo, Ket, Ket, Gg, Gg, Rrc, Rrc, Gg, Gg, Gg, Gg, Gg, Rrc, Rrc, Kh, Ch, Ch, Kh, Kh, Ch, Kh, Kh, Rrc, Rrc, Gg^Efm, Rrc, Rr, Re^Vl, Gg, Ket, Ce, Wo^Bw/, Wo, Wo, Wo, Kh, Wo, Wo, Wo, Wo, Wo, Gg
Gg, Gg, Gg, Wo, Wo, Wo, Wo, Ket, Ket, Gg, Gg, Rrc, Rrc, Kh, Rrc, Rrc, Gg, Gg, Gg, Gg, Gg, Ch, Ch, Ch, Rrc, Rrc, Gg^Efm, Gg^Efm, Gg, Gg, Gg, Rr, Rr, Re, Re, Ket, Ket, Wo, Wo, Wo, Wo, Wo, Gg, Gg, Gg, Gg
Ww, Gg, Gg, Gg, Ww, Wo, Wo, Wo, Wo, Ket, Ket, Gg, Rr, Rrc, Rrc, Gg, Gg, Gg, Gg, Gg, Gg, Kh, Rrc, Rrc, Rrc, Rr^Vhc, Gg, Gg, Gg, Gg, Gg, Rr^Vhc, Rr, Ket, Rb^Vh, Re, Rb^Vl, Ww, Wo, Wo, Gg, Gg, Gg, Gg, Gg, Gg
Gg, Ww, Ww, Ww, Gg, Gg, Gg, Wo, Wo, Wo, Wo^Bw/, Ce, Ket, Gg, Gg, Rrc, Rrc, Gg, Gg, Gg, Rrc, Rrc, Gg, Gg, Gg, Rr, Rr, Gg^Vhc, Gg, Gg, Rr, Rr, Rb, Rb, Re, Rb, Rb, Ww, Wo, Wo, Wo, Gg, Gg, Gg, Gg, Gg
Gg, Gg, Gg, Gg, Gg, Gg, Gg, Ket, Ce, Wo^Bw/, Wo, Wo, Wo, Ket, Ket, Gg, Gg, Rrc, Rrc, Rrc, Gg, Gg, Gg, Gg, Gg, Gg, Kh, Rr, Rr, Rr, Rb, Rb, Re^Vh, Rb, Re^Vh, Rb, Ww, Ww^Vhs, Ww, Wo, Wo, Gg, Gg, Gg, Gg, Gg
Gg, Gg, Gg, Gg, Gg, Gg, Gg, Gg, Re, Gg, Gg, Wo, Wo, Wo, Wo, Ket, Ket, Gg, Gg, Rrc, Rrc, Gg, Gg, Gg, Gg, Gg, Rr, Rr, Gg, Rr, Ket, Rb, Re, Ket, Rb, Rb, Ww^Vhs, Wo, Ww, Wo, Gg, Gg, Gg, Gg, Gg, Gg
Gg, Gg, Gg, Gg, Gg, Gg, Gg, Re, Gg, Gg, Gg, Gg, Gg, Wo, Wo, Wo, Wo, Ket, Ket, Gg, Gg, Rrc, Rrc, Gg, Rr, Rr, Gg, Gg, Gg, Gg, Gg, Rb, Rb, Ww, Ww, Ww^Vhs, Wo, Wo, Wo, Wo, Gg, Gg, Gg, Gg, Gg, Gg
Gg, Gg, Gg, Gg, Gg, Gg, Gg, Re, Gg, Gg, Gg, Gg, Gg, Gg, Gg, Wo, Wo, Wo, Wo, Ket, Ket, Gg, Rr, Rr, Gg, Gg, Wo, Gg, Wo, Wo, Wo, Ww, Ww, Ww^Vhs, Ww, Ww, Wo, Ww, Gg, Gg, Gg, Gg, Gg, Gg, Gg, Gg
Gg, Gg, Gg, Gg, Gg, Gg, Gg, Re, Re, Gg, Gg, Gg, Gg, Gg, Gg, Gg, Gg, Wo, Wo, Wo, Wo^Bw/, Ce, Ket, Gg, Ket, Ket, Wo, Wo, Wo, Wo, Wo, Ww, Wo, Wo, Gg, Gg, Gg, Gg, Gg, Gg, Gg, Gg, Gg, Gg, Gg, Gg
Gg, Gg, Gg, Gg, Gg, Gg, Gg, Gg, Re, Gg, Gg, Gg, Gg, Gg, Gg, Gg, Gg, Ket, Ce, Wo^Bw/, Wo, Wo, Wo, Ket, Wo, Wo, Wo, Wo, Wo, Wo, Wo, Wo, Wo, Gg, Gg, Gg, Gg, Gg, Gg, Gg, Gg, Gg, Gg, Gg, Gg, Gg
Gg, Gg, Gg, Gg, Gg, Gg, Re, Re, Gg, Gg, Gg, Gg, Gg, Gg, Gg, Gg, Re, Re, Gg, Gg, Gg, Wo, Wo, Wo, Wo, Wo, Wo, Wo, Wo, Wo, Wo, Wo, Gg, Gg, Gg, Gg, Gg, Gg, Gg, Gg, Gg, Gg, Gg, Gg, Gg, Gg
Gg, Gg, Gg, Gg, Gg, Gg, Re, Gg, Gg, Gg, Gg, Gg, Gg, Gg, Re, Re, Gg, Gg, Gg, Gg, Gg, Gg, Gg, Wo, Gg, Wo, Gg, Wo, Wo, Wo, Gg, Wo, Gg, Gg, Gg, Gg, Gg, Gg, Gg, Gg, Gg, Gg, Gg, Gg, Gg, Gg
Gg, Gg, Gg, Gg, Gg, Gg, Gg, Re, Gg, Gg, Gg, Gg, Gg, Re, Gg, Gg, Gg, Gg, Gg, Gg, Gg, Gg, Gg, Gg, Gg, Gg, Gg, Gg, Gg, Gg, Gg, Gg, Gg, Gg, Gg, Gg, Gg, Gg, Gg, Gg, Gg, Gg, Gg, Gg, Gg, Gg
Gg, Gg, Gg, Gg, Gg, Gg, Gg, Re, Gg, Gg, Gg, Gg, Re, Re, Gg, Gg, Gg, Gg, Gg, Gg, Gg, Gg, Gg, Gg, Gg, Gg, Gg, Gg, Gg, Gg, Gg, Gg, Gg, Gg, Gg, Gg, Gg, Gg, Gg, Gg, Gg, Gg, Gg, Gg, Gg, Gg
Gg, Gg, Gg, Gg, Gg, Gg, Re, Re, Re, Re, Re, Re, Gg, Re, Re, Gg, Gg, Gg, Gg, Gg, Gg, Gg, Gg, Gg, Gg, Gg, Gg, Gg, Gg, Gg, Gg, Gg, Gg, Gg, Gg, Gg, Gg, Gg, Gg, Gg, Gg, Gg, Gg, Gg, Gg, Gg
Gg, Gg, Re, Gg, Re, Re, Gg, Gg, Gg, Gg, Gg, Gg, Gg, Gg, Gg, Re, Gg, Gg, Gg, Gg, Gg, Gg, Gg, Gg, Gg, Gg, Gg, Gg, Gg, Gg, Gg, Gg, Gg, Gg, Gg, Gg, Gg, Gg, Gg, Gg, Gg, Gg, Gg, Gg, Gg, Gg
Re, Re, Gg, Re, Gg, Gg, Gg, Gg, Gg, Gg, Gg, Gg, Gg, Gg, Gg, Re, Gg, Gg, Gg, Gg, Gg, Gg, Gg, Gg, Gg, Gg, Gg, Gg, Gg, Gg, Gg, Gg, Gg, Gg, Gg, Gg, Gg, Gg, Gg, Gg, Gg, Gg, Gg, Gg, Gg, Gg
Gg, Gg, Gg, Gg, Gg, Gg, Gg, Gg, Gg, Gg, Gg, Gg, Gg, Gg, Gg, Re, Re, Gg, Gg, Gg, Gg, Gg, Gg, Gg, Gg, Gg, Gg, Gg, Gg, Gg, Gg, Gg, Gg, Gg, Gg, Gg, Gg, Gg, Gg, Gg, Gg, Gg, Gg, Gg, Gg, Gg
Gg, Gg, Gg, Gg, Gg, Gg, Gg, Gg, Gg, Gg, Gg, Gg, Gg, Gg, Gg, Gg, Gg, Re, Re, Gg, Gg, Gg, Gg, Gg, Gg, Gg, Gg, Gg, Gg, Gg, Gg, Gg, Gg, Gg, Gg, Gg, Gg, Gg, Gg, Gg, Gg, Gg, Gg, Gg, Gg, Gg
Gg, Gg, Gg, Gg, Gg, Gg, Gg, Gg, Gg, Gg, Gg, Gg, Gg, Gg, Gg, Gg, Gg, Gg, Re, Gg, Gg, Gg, Gg, Gg, Gg, Gg, Gg, Gg, Gg, Gg, Gg, Gg, Gg, Gg, Gg, Gg, Gg, Gg, Gg, Gg, Gg, Gg, Gg, Gg, Gg, Gg
Gg, Gg, Gg, Gg, Gg, Gg, Gg, Gg, Gg, Gg, Gg, Gg, Gg, Gg, Gg, Gg, Gg, Gg, Re, Gg, Gg, Gg, Gg, Gg, Gg, Gg, Gg, Gg, Gg, Gg, Gg, Gg, Gg, Gg, Gg, Gg, Gg, Gg, Gg, Gg, Gg, Gg, Gg, Gg, Gg, Gg
Gg, Gg, Gg, Gg, Gg, Gg, Gg, Gg, Gg, Gg, Gg, Gg, Gg, Gg, Gg, Gg, Gg, Gg, Gg, Re, Re, Gg, Gg, Gg, Gg, Gg, Gg, Gg, Gg, Gg, Gg, Gg, Gg, Gg, Gg, Gg, Gg, Gg, Gg, Gg, Gg, Gg, Gg, Gg, Gg, Gg
