border_size=1
usage=map

Dd, Dd, Dd, Dd, Dd, Dd, Dd, Dd, Dd, Dd, Xos, Xos, Xos, Xos, Xos, Xos, Xos, Xos, Xos, Xos, Xos, Xos, Xos, Xos, Xos, Xos, Xos, Xos, Xos, Xos, Xos, Xos, Xos, Xos, Xos, Xos, Xos, Xos, Xos, Xos, Xos, Xos, Xos, Xos, Xos, Xos, Xos, Xos, Xos, Xos, Xos, Xos, Xos, Xos, Xos
Dd, Dd, Dd, Dd, 4 Dd, Dd, 5 Dd, Dd, Xos, Xos, Ur, Xos, Xos, Xos, Ur, Ur, Ur, Xos, Xos, Xos, Ur, Ur, Xos, Xos, Xos, Xos, Ur, Ur, Ur, Xos, Xos, Ur, Ur, Ur, Xos, Xos, Xos, Xos, Xos, Xos, Ur, Xos, Xos, 1 Kud, Ur, Xos, Xos, Xos, Ur, Xos, Xos, Xos, Xos, Xos, Xos
Dd, Dd, 2 Dd, 3 Rd, Rd, Rd, Rd, Xos, Xos, Ur, Ur, Ur, Ur, Xos, Xos, Ur, Ur, Ur, Ur, Xos, Xos, Xos, Ur, Ur, Ur, Xos, Xos, Ur, Ur, Ur, Ur, Xos, Xos, Xos, Ur, Ur, Ur, Xos, Xos, Ur, Ur, Ur, Ur, Xos, Xos, Xos, Ur, Xos, Xos, Xos, Ur, Xos, Xos, Xos, Xos
Dd, Dd, Dd, Dd, Dd, Xos, Xos, Rd, Rd, Xos, Xos, Ur, Ur, Ur, Ur, Xos, Xos, Ur, Xos, Xos, Ur, Xos, Xos, Ur, Ur, Ur, Ur, Xos, Xos, Ur, Xos, Xos, Ur, Xos, Xos, Ur, Ur, Ur, Ur, Xos, Xos, Ur, Xos, Xos, Ur, Xos, Xos, Xos, Ur, Xos, Xos, Xos, Ur, Xos, Xos
Dd, Dd, Xos, Xos, Xos, Rd, Rd, Xos, Rd, Rd, Rd, Xos, Xos, Ur, Ur, Ur, Xos, Xos, Xos, Ur, Ur, Ur, Ur, Xos, Xos, Ur, Ur, Ur, Xos, Xos, Xos, Ur, Ur, Ur, Ur, Xos, Xos, Ur, Ur, Ur, Xos, Xos, Xos, Ur, Ur, Xos, Ur, Xos, Xos, Xos, Ur, Xos, Xos, Xos, Xos
Xos, Xos, Ur, Ur, Ur, Xos, Xos, Rd, Rd, Rb^Vud, Rd, Rd, Rd, Xos, Xos, Xos, Ur, Ur, Ur, Xos, Xos, Ur, Ur, Ur, Ur, Xos, Xos, Xos, Ur, Ur, Ur, Xos, Xos, Ur, Ur, Ur, Ur, Xos, Xos, Xos, Ur, Ur, Ur, Xos, Xos, Xos, Ur, Ur, Ur, Xos, Xos, Xos, Ur, Xos, Xos
Xos, Xos, Xos, Ur, Ur, Ur, Ur, Xos, Xos, Rd, Rd, Xos, Xos, Rd, Rd, Xos, Xos, Ur, Ur, Ur, Ur, Xos, Xos, Ur, Xos, Xos, Ur, Xos, Xos, Ur, Ur, Ur, Ur, Xos, Xos, Ur, Xos, Xos, Ur, Xos, Xos, Ur, Ur, Ur, Ur, Xos, Xos, Ur, Xos, Xos, Xos, Xos, Xos, Xos, Xos
Xos, Ur, Ur, Xos, Xos, Ur, Ur, Ur, Ur, Xos, Xos, Rd, Rd, Xos, Rd, Rd, Rd, Xos, Xos, Ur, Ur, Ur, Xos, Xos, Xos, Ur, Ur, Ur, Ur, Xos, Xos, Ur, Ur, Ur, Xos, Xos, Xos, Ur, Ur, Ur, Ur, Xos, Xos, Ur, Ur, Xos, Ur, Xos, Xos, Xos, Xos, Xos, Xos, Xos, Xos
Xos, Ur, Ur, Ur, Ur, Xos, Xos, Ur, Xos, Xos, Ur, Xos, Xos, Rd, Rd, Rb^Vud, Rd, Rd, Rd, Xos, Xos, Xos, Ur, Ur, Ur, Xos, Xos, Ur, Ur, Ur, Ur, Xos, Xos, Xos, Ur, Ur, Ur, Xos, Xos, Ur, Ur, Ur, Ur, Xos, Xos, Xos, Ur, Ur, Ur, Xos, Xos, Xos, Xos, Xos, Xos
Xos, Xos, Xos, Ur, Ur, Ur, Xos, Xos, Xos, Ur, Ur, Ur, Ur, Xos, Xos, Rd, Rd, Xos, Xos, Rd, Rd, Xos, Xos, Ur, Ur, Ur, Ur, Xos, Xos, Ur, Xos, Xos, Ur, Xos, Xos, Ur, Ur, Ur, Ur, Xos, Xos, Ur, Xos, Xos, Ur, Xos, Xos, Ur, Xos, Xos, Xos, Xos, Xos, Xos, Xos
Xos, Ur, Ur, Xos, Xos, Xos, Ur, Ur, Ur, Xos, Xos, Ur, Ur, Ur, Ur, Xos, Xos, Rd, Rd, Xos, Rd, Rd, Rd, Xos, Xos, Ur, Ur, Ur, Xos, Xos, Xos, Ur, Ur, Ur, Ur, Xos, Xos, Ur, Ur, Ur, Xos, Xos, Xos, Ur, Ur, Xos, Ur, Xos, Xos, Xos, Xos, Xos, Xos, Xos, Xos
Xos, Ur, Xos, Xos, Ur, Xos, Xos, Ur, Ur, Ur, Ur, Xos, Xos, Ur, Xos, Xos, Ur, Xos, Xos, Rd, Rd, Rb^Vud, Rd, Rd, Rd, Xos, Xos, Xos, Ur, Ur, Ur, Xos, Xos, Ur, Ur, Ur, Ur, Xos, Xos, Xos, Ur, Ur, Ur, Xos, Xos, Xos, Ur, Ur, Ur, Xos, Xos, Xos, Xos, Xos, Xos
Xos, Xos, Xos, Ur, Ur, Ur, Ur, Xos, Xos, Ur, Ur, Ur, Xos, Xos, Xos, Ur, Ur, Ur, Ur, Xos, Xos, Rd, Rd, Xos, Xos, Rd, Rd, Xos, Xos, Ur, Ur, Ur, Ur, Xos, Xos, Ur, Xos, Xos, Ur, Xos, Xos, Ur, Ur, Ur, Ur, Xos, Xos, Ur, Xos, Xos, Xos, Xos, Xos, Xos, Xos
Xos, Ur, Ur, Xos, Xos, Ur, Ur, Ur, Ur, Xos, Xos, Xos, Ur, Ur, Ur, Xos, Xos, Ur, Ur, Ur, Ur, Xos, Xos, Rd, Rd, Xos, Rd, Rd, Rd, Xos, Xos, Ur, Ur, Ur, Xos, Xos, Xos, Ur, Ur, Ur, Ur, Xos, Xos, Ur, Ur, Xos, Ur, Xos, Xos, Xos, Xos, Xos, Xos, Xos, Xos
Xos, Ur, Ur, Ur, Ur, Xos, Xos, Ur, Xos, Xos, Ur, Xos, Xos, Ur, Ur, Ur, Ur, Xos, Xos, Ur, Xos, Xos, Ur, Xos, Xos, Rd, Rd, Rb^Vud, Rd, Rd, Rd, Xos, Xos, Xos, Ur, Ur, Ur, Xos, Xos, Ur, Ur, Ur, Ur, Xos, Xos, Xos, Ur, Ur, Ur, Xos, Xos, Xos, Xos, Xos, Xos
Xos, Xos, Xos, Ur, Ur, Ur, Xos, Xos, Xos, Ur, Ur, Ur, Ur, Xos, Xos, Ur, Ur, Ur, Xos, Xos, Xos, Ur, Ur, Ur, Ur, Xos, Xos, Rd, Rd, Xos, Xos, Rd, Rd, Xos, Xos, Ur, Ur, Ur, Ur, Xos, Xos, Ur, Xos, Xos, Ur, Xos, Xos, Ur, Xos, Xos, Xos, Xos, Xos, Xos, Xos
Xos, Ur, Ur, Xos, Xos, Xos, Ur, Ur, Ur, Xos, Xos, Ur, Ur, Ur, Ur, Xos, Xos, Xos, Ur, Ur, Ur, Xos, Xos, Ur, Ur, Ur, Ur, Xos, Xos, Rd, Rd, Xos, Rd, Rd, Rd, Xos, Xos, Ur, Ur, Ur, Xos, Xos, Xos, Ur, Ur, Xos, Ur, Xos, Xos, Xos, Xos, Xos, Xos, Xos, Xos
Xos, Ur, Xos, Xos, Ur, Xos, Xos, Ur, Ur, Ur, Ur, Xos, Xos, Ur, Xos, Xos, Ur, Xos, Xos, Ur, Ur, Ur, Ur, Xos, Xos, Ur, Xos, Xos, Ur, Xos, Xos, Rd, Rd, Rb^Vud, Rd, Rd, Rd, Xos, Xos, Xos, Ur, Ur, Ur, Xos, Xos, Xos, Ur, Ur, Ur, Xos, Xos, Xos, Xos, Xos, Xos
Xos, Xos, Xos, Ur, Ur, Ur, Ur, Xos, Xos, Ur, Ur, Ur, Xos, Xos, Xos, Ur, Ur, Ur, Ur, Xos, Xos, Ur, Ur, Ur, Xos, Xos, Xos, Ur, Ur, Ur, Ur, Xos, Xos, Rd, Rd, Xos, Xos, Rd, Rd, Xos, Xos, Ur, Ur, Ur, Ur, Xos, Xos, Ur, Xos, Xos, Xos, Xos, Xos, Xos, Xos
Xos, Ur, Ur, Xos, Xos, Ur, Ur, Ur, Ur, Xos, Xos, Xos, Ur, Ur, Ur, Xos, Xos, Ur, Ur, Ur, Ur, Xos, Xos, Xos, Ur, Ur, Ur, Xos, Xos, Ur, Ur, Ur, Ur, Xos, Xos, Rd, Rd, Xos, Rd, Rd, Rd, Xos, Xos, Ur, Ur, Xos, Ur, Xos, Xos, Xos, Xos, Xos, Xos, Xos, Xos
Xos, Ur, Ur, Ur, Ur, Xos, Xos, Ur, Xos, Xos, Ur, Xos, Xos, Ur, Ur, Ur, Ur, Xos, Xos, Ur, Xos, Xos, Ur, Xos, Xos, Ur, Ur, Ur, Ur, Xos, Xos, Ur, Xos, Xos, Ur, Xos, Xos, Rd, Rd, Rb^Vud, Rd, Rd, Rd, Xos, Xos, Xos, Ur, Ur, Ur, Xos, Xos, Xos, Xos, Xos, Xos
Xos, Xos, Xos, Ur, Ur, Ur, Xos, Xos, Xos, Ur, Ur, Ur, Ur, Xos, Xos, Ur, Ur, Ur, Xos, Xos, Xos, Ur, Ur, Ur, Ur, Xos, Xos, Ur, Ur, Ur, Xos, Xos, Xos, Ur, Ur, Ur, Ur, Xos, Xos, Rd, Rd, Xos, Xos, Rd, Rd, Xos, Xos, Ur, Xos, Xos, Xos, Xos, Xos, Xos, Xos
Xos, Ur, Ur, Xos, Xos, Xos, Ur, Ur, Ur, Xos, Xos, Ur, Ur, Ur, Ur, Xos, Xos, Xos, Ur, Ur, Ur, Xos, Xos, Ur, Ur, Ur, Ur, Xos, Xos, Xos, Ur, Ur, Ur, Xos, Xos, Ur, Ur, Ur, Ur, Xos, Xos, Rd, Rd, Xos, Xos, Xos, Rd, Xos, Xos, Xos, Xos, Xos, Xos, Xos, Xos
Xos, Ur, Xos, Xos, Ur, Xos, Xos, Ur, Ur, Ur, Ur, Xos, Xos, Ur, Xos, Xos, Ur, Xos, Xos, Ur, Ur, Ur, Ur, Xos, Xos, Ur, Xos, Xos, Ur, Xos, Xos, Ur, Ur, Ur, Ur, Xos, Xos, Ur, Ur, Ur, Ur, Xos, Xos, Xos, Rd, Xos, Xos, Rd, Rd, Xos, Xos, Xos, Xos, Xos, Xos
Xos, Xos, Xos, Ur, Ur, Ur, Xos, Xos, Xos, Ur, Ur, Ur, Xos, Xos, Xos, Ur, Ur, Ur, Xos, Xos, Xos, Ur, Ur, Ur, Xos, Xos, Xos, Ur, Ur, Ur, Xos, Xos, Xos, Ur, Ur, Ur, Xos, Xos, Xos, Ur, Ur, Ur, Xos, Xos, Xos, Rd, Rd, Xos, Xos, Xos, Rd, Xos, Xos, Xos, Xos
Xos, Xos, Xos, Xos, Xos, Xos, Xos, Xos, Xos, Xos, Xos, Xos, Xos, Xos, Xos, Xos, Xos, Xos, Xos, Xos, Xos, Xos, Xos, Xos, Xos, Xos, Xos, Xos, Xos, Xos, Xos, Xos, Xos, Xos, Xos, Xos, Xos, Xos, Xos, Xos, Xos, Xos, Xos, Xos, Xos, Xos, Xos, Xos, Rd, Xos, Xos, Rd, Rd, Xos, Xos
Xos, Xos, Xos, Xos, Xos, Xos, Xos, Xos, Xos, Xos, Xos, Xos, Xos, Xos, Xos, Xos, Xos, Xos, Xos, Xos, Xos, Xos, Xos, Xos, Xos, Xos, Xos, Xos, Xos, Xos, Xos, Xos, Xos, Xos, Xos, Xos, Xos, Xos, Xos, Xos, Xos, Xos, Xos, Xos, Xos, Xos, Xos, Xos, Xos, Rd, Rd, Xos, Xos, Xos, Xos
Xos, Xos, Xos, Xos, Xos, Xos, Xos, Xos, Xos, Xos, Xos, Xos, Xos, Xos, Xos, Xos, Xos, Xos, Xos, Xos, Xos, Xos, Xos, Xos, Xos, Xos, Xos, Xos, Xos, Xos, Xos, Xos, Xos, Xos, Xos, Xos, Xos, Xos, Xos, Xos, Xos, Xos, Xos, Xos, Xos, Xos, Xos, Xos, Xos, Xos, Xos, Xos, Xos, Xos, Xos
Xos, Xos, Xos, Xos, Xos, Xos, Xos, Xos, Xos, Xos, Xos, Xos, Xos, Xos, Xos, Xos, Xos, Xos, Xos, Xos, Xos, Xos, Xos, Xos, Xos, Xos, Xos, Xos, Xos, Xos, Xos, Xos, Xos, Xos, Xos, Xos, Xos, Xos, Xos, Xos, Xos, Xos, Xos, Xos, Xos, Xos, Xos, Xos, Xos, Xos, Xos, Xos, Xos, Xos, Xos
Xos, Xos, Xos, Xos, Xos, Xos, Xos, Xos, Xos, Xos, Xos, Xos, Xos, Xos, Xos, Xos, Xos, Xos, Xos, Xos, Xos, Xos, Xos, Xos, Xos, Xos, Xos, Xos, Xos, Xos, Xos, Xos, Xos, Xos, Xos, Xos, Xos, Xos, Xos, Xos, Xos, Xos, Xos, Xos, Xos, Xos, Xos, Xos, Xos, Xos, Xos, Xos, Xos, Xos, Xos
Xos, Xos, Xos, Xos, Xos, Xos, Xos, Xos, Xos, Xos, Xos, Xos, Xos, Xos, Xos, Xos, Xos, Xos, Xos, Xos, Xos, Xos, Xos, Xos, Xos, Xos, Xos, Xos, Xos, Xos, Xos, Xos, Xos, Xos, Xos, Xos, Xos, Xos, Xos, Xos, Xos, Xos, Xos, Xos, Xos, Xos, Xos, Xos, Xos, Xos, Xos, Xos, Xos, Xos, Xos
Xos, Xos, Xos, Xos, Xos, Xos, Xos, Xos, Xos, Xos, Xos, Xos, Xos, Xos, Xos, Xos, Xos, Xos, Xos, Xos, Xos, Xos, Xos, Xos, Xos, Xos, Xos, Xos, Xos, Xos, Xos, Xos, Xos, Xos, Xos, Xos, Xos, Xos, Xos, Xos, Xos, Xos, Xos, Xos, Xos, Xos, Xos, Xos, Xos, Xos, Xos, Xos, Xos, Xos, Xos
Xos, Xos, Xos, 6 Kud, Cud, Xos, Xos, Xos, Xos, Xos, Xos, Xos, Xos, Xos, Xos, Xos, Xos, Xos, Xos, Xos, Xos, Xos, Xos, Xos, Xos, Xos, Xos, Xos, Xos, Xos, Xos, Xos, Xos, Xos, Xos, Xos, Xos, Xos, Xos, Xos, Xos, Xos, Xos, Xos, Xos, Xos, Xos, Xos, Xos, Xos, Xos, Xos, Xos, Xos, Xos
Xos, Xos, Xos, Xos, Xos, Xos, Xos, Xos, Xos, Xos, Xos, Xos, Xos, Xos, Xos, Xos, Xos, Xos, Xos, Xos, Xos, Xos, Xos, Xos, Xos, Xos, Xos, Xos, Xos, Xos, Xos, Xos, Xos, Xos, Xos, Xos, Xos, Xos, Xos, Xos, Xos, Xos, Xos, Xos, Xos, Xos, Xos, Xos, Xos, Xos, Xos, Xos, Xos, Xos, Xos
Xos, Xos, Xos, Xos, Xos, Xos, Xos, Xos, Xos, Xos, Xos, Xos, Xos, Xos, Xos, Xos, Xos, Xos, Xos, Xos, Xos, Xos, Xos, Xos, Xos, Xos, Xos, Xos, Xos, Xos, Xos, Xos, Xos, Xos, Xos, Xos, Xos, Xos, Xos, Xos, Xos, Xos, Xos, Xos, Xos, Xos, Xos, Xos, Xos, Xos, Xos, Xos, Xos, Xos, Xos
