border_size=1
usage=map

Gll^Ftr, Gll^Ftr, Gll^Ftr, Gll^Ftr, Gll^Ftr, Gll^Ftr, Gll^Ftr, Gs^Ft, Gll^Efm, Gll^Ftr, Gll^Ftr, Gll^Ftr, Gll^Ftr, Gll^Ftr, Gll^Ft, Gll^Ft, Gll^Ft, Gll^Ft, Gll^Ft, Gs, Gs^Fds, Gs^Fds, Hh^Fds, Gs^Fds, Gs^Fds, Gs, Gs^Fds, Gs^Fds, Hh^Fds, Hh^Fds, Hh^Fds, Ww, Ww, Gs^Fds, Gs^Fds, Hh^Fds, Re, Re, Re, Re, Gs^Fds, Gs^Fds, Gs^Fds, Gs^Fds, Hh^Fds, Gs^Fds
Gll^Ftr, Hhd, Gll^Ftr, Gll^Ftr, Gll^Em, Gll^Ftr, Md, Gll^Ftr, Gll^Ftr, Gll^Efm, Gll^Efm, Gll^Ftr, Gll^Ftr, Hhd, Gll^Ft, Gll, Gll^Ft, Gll^Ft, Gll^Fds, Gs, Gs^Fds, Gs^Fds, Mm, Hh, Cv, Gs^Efm, Cv, Gs^Efm, Cv, Hh, Gs, Hh^Fds, Gs^Fds, Ww, Wwf, Re, Re^Es, Re, Gs^Fds, Hh^Fds, Gs^Fds, Gs^Fds, Gs, Gs^Fds, Gs^Fms, Gs^Fds
Wwt, Gll^Ftr, Gll^Ftr, Gll^Ftr, Gll^Ftr, Gll^Ftr, Gll^Ftr, Gll^Ftr, Gll^Ftr, Cv, Gll^Efm, Gll^Ftr, Gll^Em, Gll^Ftr, Gll^Ft, Gll^Ftr, Gll^Ft, Gll^Ft, Hhd^Ft, Hh^Fds, Gs^Fds, Gs, Hh, Cv, Gg^Ve, Gg^Efm, Gg^Efm, Gg^Efm, Gg^Ve, Cv, Gs^Fds, Gs^Fms, Rb, Rb, Rb^Es, Wwf, Wwf, Gs^Vl, Gs^Fds, Hh^Fms, Gd^Fds, Hh^Fms, Gs^Fds, Gs^Fds, Gs^Fds, Gs^Fds
Gll^Ftr, Wwt, Wwt, Wwt, Wwt, Gll^Ftr, Md, Gll^Ftr, Gll^Efm, Gll^Efm, Gll^Ftr, Gll^Ftr, Gll^Ftr, Gll^Ftr, Gll^Ft, Gll^Ft, Gll^Ft, Gll^Ft, Gll^Ft, Hh^Fds, Gs^Fds, Gs^Fds, Gg^Ve, Cv, Gg^Efm, Gg^Efm, Gg^Ve, Gg^Efm, Gg^Efm, Cv, Hh, Gs^Fds, Rb, Gs^Fds, Gs^Fds, Gs^Fds, Ww, Ket, Gs, Gs, Gs^Fds, Mm, Gs^Fms, Gs^Em, Gs^Fds, Gs^Fds
Gll^Ftr, Gll^Ftr, Gll^Ftr, Gll^Em, Gll^Ftr, Wwt, Wwt, Gll^Ftr, Gll^Efm, Gll^Ftr, Wwt, Gll^Ftr, Gll^Ftr, Gll^Ft, Hhd^Ft, Gll^Ft, Hhd^Ft, Hhd^Ft, Gll^Ft, Gll^Ft, Gs^Fds, Gs^Fds, Gg, Gs^Efm, Cv, Gg^Efm, Gg^Efm, Gg^Efm, Cv, Gs^Efm, Gs, Gs^Fds, Hh^Fds, Rb, Gs, Hh^Fds, Gs, Ww, Ww, Gs, Hh^Fds, Gd^Fms, Gs, Gs, Gd^Fdw, Gs
Gll^Ftr, Gll^Ftr, Gll^Ftr, Gll^Ftr, Hhd, Gll^Ftr, Gll^Ftr, Wwt, Wwt, Wwt^Bh\, Gll^Efm, Wwt, Wwt, Hhd^Ftr, Wwt, Wwt, Wwt, Gll^Ft, Wwt, Gll^Ft, Gs^Fds, Gs^Fds, Gg^Efm, Gg^Efm, Gs^Fds, Cv, Gs^Ve, Cv, Gs^Fds, Gs^Fds, Gs^Fds, Gs, Rb^Es, Rb, Gs^Fms, Gs^Fms, Gs^Fds, Gs^Es, Ww, Hh, Gs, Gd, Gs^Fdw, Gs^Fdw, Gs^Fdw, Gs
Gll^Ftr, Gll^Em, Gll^Ftr, Gll^Ftr, Gll^Ftr, Gll^Ftr, Md, Cv, Gll^Ftr, Gll^Ftr, Gll^Ftr, Gll^Efm, Gll^Ftr, Wwt, Gll^Ftr, Gll^Ft, Gll^Ft, Wwt, Gll^Ft, Wwt, Wwt, Hh^Fds, Gg^Efm, Cv, Gs^Fds, Gg, Gg^Efm, Gs, Gs^Fds, Gs, Rb, Rb, Hh^Fds, Rb, Gs^Fds, Gs, Gs^Fms, Hh^Fds, Ww, Hh, Hh, Gd, Gd^Fdw, Gs, Ss, Gll^Fdw
Gll^Ftr, Gll^Ftr, Gll^Ftr, Gll^Em, Gll^Em, Gll^Ftr, Gll^Ftr, Gll^Ftr, Gll^Em, Gll^Ve, Gll^Efm, Gll^Efm, Gll^Ftr, Gll^Ftr, Gll^Ftr, Gll^Ftr, Gll, Gll^Ft, Hhd^Ft, Gll^Ft, Cv, Wwt, Wwt, Wwt, Wwt, Gs^Fds, Kv, Gg^Efm, Rb, Rb, Hh^Fds, Hh^Fds, Hh^Fds, Gs^Fds, Hh^Fds, Gs^Fds, Gs^Fms, Hh, Gs, Ww, Ww, Gs^Fdw, Gd^Fdw, Gs^Fdw, Ss, Ss
Gll, Gll^Ftr, Hhd, Gll^Ftr, Md, Gll^Ftr, Gll^Ftr, Gll, Gll^Ftr, Gll^Efm, Gll^Ftr, Gll^Ftr, Gll^Ftr, Hhd, Gll^Ftr, Gll^Ftr, Gll^Ft, Gll^Ft, Hhd^Ft, Gll^Ft, Gll^Efm, Gll^Efm, Gs^Fds, Hh^Fms, Hh, Wwt, Gg^Ve, Rb, Rb, Rb^Es, Gs^Fds, Gs^Fds, Hh^Fds, Gs^Fms, Gs, Gs^Fds, Mm, Gs^Fds, Gs^Fds, Ket, Ww, Gs^Fdw, Gs^Fdw, Ss, Ss, Ss
Gll^Ftr, Gll^Ftr, Gll^Ftr, Gll^Ftr, Gll^Ftr, Gll, Gll^Ftr, Gll^Ftr, Gll^Ftr, Gll^Efm, Gll^Efm, Gll^Ve, Gll^Efm, Hhd^Ftr, Gll^Efm, Gll^Ftr, Gll^Efm, Gll^Ft, Gll^Efm, Gll^Efm, Gll^Ft, Gs^Fds, Gs^Fms, Gs^Fms, Hh^Fms, Wwt, Wwt, Rb, Rb, Cv, Wwt, Gs^Fds, Wwt, Gs^Fds, Ket, Gs^Em, Gd^Fds, Gs^Fds, Gs^Fdw, Gs^Fdw, Gd, Ww, Ss, Ss, Ss, Ss
Gll^Ftr, Gll^Ftr, Gll^Ftr, Gll^Em, Gll^Ftr, Hhd, Hhd, Hhd, Gll^Ftr, Gll^Ftr, Gll^Efm, Gll^Efm, Gll^Ftr, Gll^Efm, Gll^Ft, Gll^Efm, Gll^Ft, Gll^Efm, Gll^Ft, Gll^Ft, Gll^Ft, Gll^Ft, Gs^Ft, Gs^Fms, Gd, Hh^Fds, Gg, Wwf, Wwf, Wwf, Gs, Wwt, Gs, Wwt, Wwt, Gs, Gs, Gs, Hh^Fdw, Gs^Fdw, Gd, Ss, Ss, Ss, Ss, Ss
Mm^Xm, Mm^Xm, Mm^Xm, Md, Gll^Ftr, Gll^Ftr, Gll^Ftr, Gll^Ftr, Gll^Ftr, Gll^Efm, Gll^Ftr, Gll^Ftr, Gll^Ftr, Gll^Ftr, Gll^Ftr, Hhd, Hhd, Hhd^Ft, Gll^Ft, Hhd^Ft, Hhd^Ft, Gll^Ft, Gll^Fds, Gs^Ftp, Gll^Fds, Gs^Fds, Gll^Fds, Rd, Rd, Gs^Fds, Gs^Fds, Gs^Fdw, Gs^Fdw, Gs^Fdw, Gd^Fdw, Ss, Ss, Gs^Fdw, Gs^Fdw, Gd^Fdw, Ss, Ss, Ss, Ss, Ss, Ss
Md, 1 Md, Mm^Xm, Gll^Ftr, Gll^Ftr, Gll^Ftr, Gll^Em, Gll^Ftr, Gll^Ftr, Gll^Efm, Gll^Ftr, Hhd, Gll^Ftr, Gll^Em, Gll^Ft, Gll^Ft, Gll^Ft, Gll^Ft, Gs^Ft, Hhd^Ft, Gll^Ft, Gll^Ft, Gll^Ftp, Gll^Fds, Gll^Efm, Gll^Fds, Gg^Efm, Rd, Rd, Rd^Es, Gs^Fds, Gs^Fds, Gs^Fdw, Hh^Fdw, Gd^Fdw, Gd^Fdw, Ss, Ss, Ss, Ss, Khs, Gd^Fdw, Gd^Fdw, Ss, Ss, Ss
Md, Mm^Xm, Md, Md, Hhd^Fds, Gll^Ftr, Gll^Efm, Gll^Efm, Gll^Efm, Gll^Efm, Gll^Em, Gll^Ftr, Gll^Ftr, Gll^Ftr, Gll^Ftr, Gll^Ftr, Gll^Ft, Gll^Ftp, Gll^Ftp, Gll^Ftp, Gll^Ftp, Gll^Ftp, Gll^Fds, Gll^Fds, Gs^Fds, Gg^Efm, Gg^Efm, Gg^Ve, Gs^Fds, Rd, Rd, Gs^Fds, Hh^Fds, Gs^Fdw, Gs^Fdw, Gd^Fdw, Gs^Fdw, Ss, Ss, Chs, Chs, Ss, Gd, Ss^Vhs, Ss, Ss
Md, Md, Md, Hhd^Fp, Gll^Fms, Gll^Efm, Gll^Ve, Gll^Fds, Gll^Efm, Gll^Ft, Gll^Ft, Gll^Ft, Hh^Ft, Gs^Ft, Gs^Ft, Gll^Ft, Gll^Em, Gll^Efm, Gll^Ve, Gll^Efm, Gll^Efm, Gll^Efm, Gg^Efm, Gs^Fds, Gg, Gg^Efm, Gs^Fds, Gg^Efm, Gs^Fds, Gs^Fms, Rd, Gs^Fms, Gs, Gd^Fds, Gs^Vl, Gs^Fds, Gs^Fdw, Gs, Gs^Fdw, Ss, Ss, Ss, Gd, Gd, Ss, Ss
Hh^Fds, Hh^Fp, Hh^Fds, Hh^Fp, Gll^Fms, Gll^Efm, Gll^Efm, Gll^Fds, Gll^Efm, Gll^Ft, Gll^Fds, Gll^Ft, Gll^Fds, Hh^Ft, Gs^Fds, Gs^Fds, Gs^Fds, Gs^Fds, Cv, Gs^Fds, Cv, Gs^Fds, Gg^Ve, Gg^Efm, Gs^Fds, Gs^Fds, Cv, Gs^Fds, Gs, Gs^Fms, Rd, Rd, Rd, Gd, Gd^Fds, Gd^Fds, Gs^Fds, Gd^Fdw, Hh^Fdw, Ss, Ss, Ss, Ss, Gd^Fdw, Ss, Ss
Gs^Fms, Gs^Fds, Gs^Fds, Hh^Fms, Gll^Fds, Gll^Fds, Gs^Efm, Hh^Fds, Gll^Fds, Gll^Efm, Gll^Efm, Gll^Fds, Gs^Fds, Hh^Fds, Gs^Fds, Gs^Fds, Gs^Fds, Gg^Efm, Cv, Cv, Gs^Fds, Gs^Fds, Gg^Efm, Gg^Efm, Gs^Fds, Gs^Fds, Cv, Gs^Fds, Gs^Fds, Hh^Fms, Hh^Fms, Hh^Fds, Rd, Rd, Gd^Fms, Mm, Hh^Fds, Gs^Fdw, Gs^Fdw, Gs^Fdw, Ss^Vhs, Ss, Ss, Ss, Ss, Ss
Gs, Gs^Fms, Gs, Gs^Fds, Gs^Fms, Cv, Gs^Fds, Hh^Fds, Gs^Fds, Gll^Fds, Gg^Ve, Gs^Fds, Gs^Efm, Gs^Fds, Gs^Efm, Gg^Ve, Gg^Efm, Gg^Efm, Gs^Fds, Kv, Gs^Fds, Gg^Efm, Gg^Efm, Hh^Fds, Hh^Fds, Gs^Fds, Gs^Fds, Gs^Fds, Rd, Gs^Fds, Rd, Hh^Fds, Rd, Gs^Fds, Gs^Fds, Hh^Fds, Hh^Fds, Gs^Fdw, Gd^Fdw, Ss, Wo, Wo, Ss, Ss, Ss, Ss
Gs^Fms, Gs^Fms, Gs^Fds, Gs^Fms, Cv, Kv, Cv, Gs^Efm, Gs^Efm, Gs^Efm, Gg^Efm, Gg^Efm, Gs^Fds, Gs^Efm, Gs^Fds, Gs^Fds, Gs^Fds, Gg^Efm, Gg^Efm, Gg^Efm, Gg^Efm, Gs^Fds, Gg^Efm, Gg^Efm, Hh^Fds, Gs^Fds, Gs^Fds, Gs^Fds, Gs^Fds, Rd, Gs^Fds, Rd^Es, Rd, Rd, Ww^Bw\, Hh^Fds, Gs^Fds, Hh^Fds, Ww^Ewf, Wwf, Wo, Ss, Gs^Fdw, Gs^Fdw, Gs^Fdw, Ss
Hh^Fms, Gs^Fms, Hh^Fms, Gs^Fms, Rp, Gg^Ve, Gs^Fms, Gs^Fds, Gs^Fms, Gs^Fds, Gs^Efm, Gs^Fms, Gs^Fms, Gg^Ve, Gs^Fds, Gs^Fms, Gs^Fms, Hh^Fds, Gs^Fds, Gs^Fds, Gs^Fds, Gg^Ve, Gs^Fds, Gs^Efm, Gs^Efm, Gs^Fds, Gg^Efm, Gs^Fds, Hh^Fds, Hh^Fds, Gs^Fds, Gs^Fds, Wo, Ww, Wo^Bw|, Ww, Wo, Wo, Wo, Ww, Wwf, Gs^Fdw, Hh^Fds, Gd^Fdw, Gs^Fdw, Gs^Fdw
Hh^Fms, Hh^Fms, Hh, Rp, Hh^Fp, Hh^Fms, Hh, Hh^Fms, Hh^Fms, Hh^Fms, Rp, Gs^Fms, Hh^Fms, Gs^Fms, Gs^Fms, Gs^Fms, Gs^Fds, Gs^Fds, Gs^Fms, Gs^Fds, Gs^Fds, Gs^Fds, Gs^Fds, Gs^Fms, Gs^Fds, Gg^Efm, Gg^Ve, Gs^Efm, Wo, Ss, Wo^Ewf, Wwf, Ww, Wo^Bw|, Rd, Ww, Wo, Ww, Gs^Fds, Ww, Gs^Fds, Hh^Fds, Gs^Fds, Gd^Fds, Gs^Fds, Gs^Fdw
Hh^Fp, Hh^Fp, Hh, Rp, Rp, Hh^Fp, Hh, Hh^Fp, Hh, Hh^Fms, Rp, Hh, Hh^Fp, Hh^Fms, Hh^Fms, Hh^Fms, Hh^Fms, Gs, Hh, Gs^Fms, Gs^Fms, Cv, Kv, Cv, Gs^Fds, Gs^Fds, Wwf, Wwf, Wo, Wo, Ww, Ww, Ket, Rd, Rd, Hh, Ket, Hh, Gg^Efm, Gs^Fds, Gs^Efm, Gs^Fds, Gs^Fds, Gs^Fds, Gs^Fds, Gs^Fds
Hh^Fp, Hh, Hh, Hh^Fp, Hh, Rp, Hh^Fp, Hh, Hh^Fp, Hh^Fp, Chr, Rr^Vhc, Hh^Fp, Hh^Fp, Hh^Fp, Hh^Fp, Hh^Fp, Hh^Fms, Hh, Gs^Fms, Hh^Fms, Gs^Efm, Gs^Fms, Gs^Fms, Gs^Fms, Gs^Fms, Ww, Wwf, Gs^Fds, Ket, Hh, Hh, Gg^Edt, Rd, Rd, Hh, Gg, Ce, Gs^Fds, Gs^Efm, Gs^Fds, Gg^Efm, Gg^Ve, Gg^Efm, Gs^Fds, Gs^Fds
Hh^Fms, Hh, Hh^Fms, Rr^Vhc, Kh, Rp, Ch, Rr^Vhc, Rp, Rp, Ch, Hh^Fp, Hh^Fp, Hh^Fp, Hh^Fp, Hh^Fp, Hh^Fp, Hh, Hh^Vc, Hh^Fms, Hh^Fp, Gg^Efm, Hh^Fms, Gs^Fms, Ww, Ww, Wwf, Gs^Fms, Gs^Fds, Ce, Ce, Gg, Gg^Vh, Rd, Rd, Gg^Vh, Gs^Fds, Ce, Ce, Gs^Fds, Gd^Fds, Gg^Efm, Gs^Fds, Gg^Efm, Gd^Fds, Gs^Fds
Hh, Hh, Hh, Ch, Hh^Fms, Hh, Hh^Vhh, Ch, Hh, Kh, Re, Hh^Fms, Hh^Fms, Hh, Hh^Fp, Hh^Fp, Hh^Fp, Hh, Hh^Fp, Hh^Fp, Hh, Gg^Efm, Hh^Fms, Hh^Fms, Ww, Wo, Gs^Fms, Gs^Fms, Gs, Gs^Fds, Hh, Hh, Gg, Rd, Rd, Gg, Ce, Gs^Fds, Gs^Fds, Gs^Fds, Gd^Fds, Gs^Fds, Gs^Fds, Gs^Fds, Hh^Fds, Hh^Fds
Gs, Hh, Gs^Fms, Rp, Gs^Fms, Hh^Fms, Gs^Fms, Re, Hh, Hh^Fms, Re, Hh^Vhh, Hh, Hh, Mm, Mm, Mm, Hh^Fp, Wwf, Wwf^Ewf, Wwf, Wwf, Wwf, Hh^Fms, Wo^Ewf, Ww, Ww^Vhs, Gs^Fms, Gs^Fms, Gs^Fms, Hh, Ce, Ket, Rd, Rd, Gg^Vh, Ce, Gs^Fds, Gg^Efm, Gs^Fds, Gg^Efm, Gg^Efm, Hh, Hh^Fds, Hh, Hh^Fds
Gs^Fds, Gs, Gs, Gs, Gs, Gs^Fms, Gs, Re, Re, Re, Gs, Gs^Fms, Gs^Fms, Hh^Fms, Hh^Fms, Mm, Hh^Fms, Hh^Fms, Chr, Hh^Fms, Hh, Hh^Fp, Hh^Fp, Ww, Wo, Wo, Hh^Fms, Hh^Fms, Hh^Fms, Gs^Fms, Gs^Fp, Hh, Rd, Rd^Es, Rd, Ket, Gg^Efm, Gg^Efm, Gs^Fds, Gg^Efm, Gg^Ve, Gg^Efm, Cv, Hh, Gs^Fds, Hh^Fds
Gs^Fds, Gs^Es, Gs, Gs, Gs, Gs^Edt, Gs, Gs^Fds, Re, Gs^Fds, Gs^Fds, Gs, Gs^Fds, Gs^Fms, Rp, Rp, Rp, Khr, Ch, Hh^Fms, Hh^Fms, Hh, Mv, Wo, Mm, Ss, Hh, Hh^Fms, Hh^Fms, Hh^Fms, Re, Rd, Rd, Rd, Gs^Fms, Gs^Fms, Hh, Gg^Es, Gs^Fds, Gg^Efm, Gg^Efm, Cv, Kv, Gs^Fds, Gs^Fms, Gs^Fds
Wwr, Gs^Fds, Ww, Gs^Vht, Ss, Gs^Fds, Gs, Gs, Re, Gs, Chr, Gs, Rp, Gs^Fms, Rp, Hh^Fms, Hh^Fms, Chr, Hh^Fms, Hh^Fms, Mm, Mm, Mm, Mm, Mm, Mm, Hh, Hh^Fp, Hh^Fp, Hh^Fms, Re, Re, Hh^Fms, Gs^Fms, Gs^Fms, Gs^Fms, Hh, Gs^Fms, Gs^Fds, Gs^Fms, Gg^Efm, Gg^Ve, Cv, Gg^Efm, Gs^Fds, Gs^Fds
Wwr, Wwr, Wo^Ewf, Wo, Wo, Ww, Wwr, Hh^Fds, Rp, Rp, Rp, Rp, Hh, Rp, Gs^Fds, Gs^Fms, Gs^Fds, Hh^Fms, Hh^Fms, Hh, Hh, Mm, Mm, Mm, Hh^Fms, Mm, Mm, Hh, Hh^Fp, Hh^Fms, Re, Re, Hh^Fms, Hh^Fms, Hh, Gs^Fms, Gs^Fms, Gs^Fms, Gs^Fms, Gs^Fds, Gg^Efm, Gg^Efm, Gs^Fds, Gg^Efm, Gs^Fds, Gs^Fds
Wwr, Wwr, Wo, Wo, Wo, Ww, Wwf, Rp, Wwr, Hh^Fds, Gs^Fds, Gs^Fms, Hh, Gs^Fds, Gg, Gs^Fds, Gg, Hh^Fms, Gs^Fms, Hh, Ww^Ewf, Hh, Hh, Hh, Hh^Fms, Mm, Mm, Hh, Hh^Fp, Hh^Fp, Rb, Re, Ket, Hh^Fms, Hh^Fms, Gs^Fms, Gs^Fms, Gg^Efm, Gg^Efm, Gs^Fds, Gg^Efm, Gs^Fds, Hh, Gg^Efm, Gs^Fds, Gs^Fms
Wwr, Wwf, Ww, Wo, Ww, Wo, Wwf, Wwf, Ww, Ww^Vhs, Gs^Fds, Hh^Fds, Gg, Gs^Fds, Gg, Gs^Fds, Gg^Vc, Gg^Edt, Gg, Wwf, Wo, Ww, Wwf, Hh, Hh^Fms, Hh, Hh, Hh, Rb, Rb, Rb, Rb, Hh^Fp, Hh^Fp, Hh, Hh, Gs^Fms, Cv, Cv, Gg^Efm, Gs^Fds, Hh, Gg^Efm, Gg^Efm, Gs^Fds, Gs^Fds
Gs^Fds, Hh^Fds, Gs, Hh^Fds, Hh, Wwf, Wo, Ww, Wo, Ww, Ww, Hh^Fds, Gs^Fds, Gg^Es, Hh, Gg, Gs^Fms, Gg, Gs^Fds, Wwf, Wwf, Wo, Wwf, Hh, Hh^Fms, Hh^Fms, Rb, Rb, Rb, Rb, Hh, Hh, Hhd^Fp, Hhd^Fp, Hhd^Fms, Hh, Gs, Gs^Fds, Kv, Gg^Efm, Gs^Fds, Gs^Fds, Gg^Efm, Gs^Fds, Gs^Fds, Gs^Fds
Gs^Fds, Gs^Fds, Gs, Gs^Vhcr, Rp, Chw, Wo, Ww, Wo, Wo, Ww, Gs^Fds, Wo, Wo, Gs^Fds, Gs^Fds, Gs^Fds, Gg, Gg, Wwf, Hh, Wwf, Gs^Fds, Gs^Fms, Hh^Vhh, Ket, Re, Rb, Hh^Fms, Hh, Mm, Mv, Mm, Hhd, Hhd, Gs, Hh^Fms, Gs^Efm, Gg^Efm, Gg^Efm, Gs^Fds, Gs^Fms, Gg^Efm, Gg^Ve, Gs^Fds, Gs^Fms
Gs^Fms, Gs^Fds, Gs^Fds, Gs^Fds, Rp, Gs^Fds, Gs^Fds, Wo, Ww^Ewf, Ww, Wo, Ww, Ww, Wwr, Chw, Khw, Wo, Wo, Gg, Gs^Fds, Hh^Fds, Gg, Gs^Fds, Gg, Re, Re, Re, Hh^Fms, Hh^Fms, Hhd, Hhd, Mm, Hhd, Hhd, Hhd^Fp, Hhd, Hhd^Fms, Hh, Gs^Fms, Cv, Gg^Efm, Gs^Fds, Gs^Fds, Gg^Efm, Gs^Fds, Gs^Fds
Gs^Fms, Gs^Fms, Rp, Rp, Rp, Gs^Fds, Gs^Fds, Ss, Wo, Wo, Wo, Ww, Ww, Wwf, Wwf, Chw, Ww, Ww, Ww^Ewf, Hh, Gs^Fds, Hh^Fds, Gg, Gs^Fds, Rd^Es, Re, Gs^Fms, Hh^Fms, Hh^Fms, Chr, Hhd^Fms, Hhd^Fp, Hhd, Chr, Hhd^Fp, Hhd, Hhd^Vo, Hh, Hhd^Fp, Gs^Fms, Gs^Efm, Gg, Gs^Fds, Gg^Efm, Gs^Fds, Gs^Fds
Hh^Fms, Hh, Hh, Chr, Chr, Rp, Gs, Gs^Vl, Gs^Fds, Ww, Gs^Fds, Wo, Wwf, Wwf, Wo, Wo, Ww, Wo, Ww, Ss, Gs^Fds, Gs^Fds, Rd, Rd, Rd, Rd, Gs^Fms, Hh^Fms, Hh, Kh, Hhd, Hhd, Mv, Hhd^Fp, Hhd^Fp, Hhd^Fp, Hhd^Fp, Hhd, Rb, Rb, Gs, Gs^Fms, Gs^Fds, Gs^Fds, Gs^Fds, Gs^Fds
Hh^Fp, Hh^Fms, Hh, Khr, Chr, Gs^Fds, Gs^Es, Gs, Gs, Gs, Gs, Gs, Gs^Fds, Wwf, Wwf, Wo, Wo, Wo, Wo, Ww, Ww, Wwf, Rd, Rd, Gs^Fds, Gs^Fms, Gs^Fms, Hh, Hh, Hh, Hhd, Mm, Mm, Mm, Hhd^Fp, Hhd^Fp, Hhd^Fp, Rb, Hhd^Fms, Gs^Fms, Gs^Fms, Gs^Es, Gs^Fms, Hh^Fds, Gs^Fds, Gs^Fds
Hh^Fp, Hh^Fms, Hh, Hh^Vhh, Chr, Gs^Fms, Gs^Fms, Gs^Fms, Gs, Gs^Fds, Gs, Gs^Fds, Gs^Vl, Gs, Gs, Gs, Ww, Wo, Wo, Ww, Wwf, Wwf, Wwf, Hh^Fds, Gs^Fds, Gs^Fds, Gs^Fds, Gs^Fms, Hh, Hh, Hhd, Hhd^Fp, Hhd^Fp, Hhd^Fp, Mv, Hhd^Fp, Rb, Rb, Hhd^Fp, Hh^Fds, Gs^Fms, Gs^Fms, Gs^Fms, Gs^Fds, Gs^Fms, Gs^Fds
Hh^Fp, Hh^Fp, Hh^Fms, Hh, Hh, Hh, Hh, Hh, Hh, Gs, Gs, Gs^Fds, Gs, Gs, Gs, Ket, Ce, Ww^Vhs, Ww, Wo, Wwf, Wwf, Ww, Re, Re, Gg, Gg, Gg, Gs^Fms, Hh^Vhh, Hhd, Hhd^Fp, Hhd^Fp, Mm, Mm, Mm, Rb, Hhd^Fp, Hhd^Fp, Hhd^Fp, Gs^Fms, Gs, Gg, Gg, Gs^Fms, Gs^Fms
Hh^Fp, Hh^Fp, Hh^Fp, Hh^Fp, Hh, Hh^Vhh, Hh, Hh, Hh, Gs, Gs^Fds, Gs, Gs^Fds, Gs^Es, Gs, Gs, Ce, Rd, Rd, Wwf, Wwf, Wo, Wo, Ww^Vhs, Ww, Re, Gs^Fds, Gg, Gs^Fms, Hh, Hh, Hhd^Fp, Khr, Hhd^Fp, Rb, Rb, Mv, Hhd^Fp, Hhd^Fp, Hhd^Fp, Hh^Fms, Gs^Fms, Gs, Gg^Fet, Gg, Gs^Fms
Mm, Hh^Fp, Hh^Fp, Hh^Fp, Hh^Fms, Hh^Fms, Hh, Hh, Hh, Hh, Gs^Fms, Gs^Fms, Gs^Fms, Gs^Vl, Gs, Gs, Ce, Ket, Rd, Wwf, Ww, Ww, Wo, Wo, Wo, Re, Re, Gg, Gs^Fds, Gs, Hh, Hhd, Hhd, Chr, Rb, Mm, Mm, Mm, Hhd^Fp, Hhd^Fp, Hhd^Fp, Hh^Fms, Gs^Fms, Gs^Fms, Gg, Gs^Fms
Mm, Mm, Mm^Xm, Hh^Fp, Hh^Fp, Hh, Hh^Fp, Hh, Hh, 5 Hh, Hh, Hh^Fms, Rd, Gs^Fms, Rd, Gs, Rd, Rd, Gs, Ce, Ket, Ww, Ww^Ewf, Wo, Wo, Gs^Fds, Re, Gs^Fms, Re, Gs, Re, Hhd^Fms, Rb, Rb, Hhd^Fms, Hhd^Fp, Hhd^Fp, Hhd^Fp, Hhd^Fp, Hhd^Fp, Hhd^Fp, Hh^Fp, Hh^Fms, Gs^Fms, Hh^Fms, Gg
Mm, Mm^Xm, 6 Mm, Mm^Xm, Hh^Fp, Hh^Fp, Hh, Hh^Fp, Hh, 3 Hh, 2 Rd, Rd, Hh^Vhh, Rd, Hh, Rd, Rd, Gs^Fds, Gs, Gs, Gs^Fds, Ww, Wo, Wo, Ww, Ww, Gs^Fds, Re, Gs^Fds, Re, Gs^Fms, Re, Hh, Hh^Fds, Hhd, Hhd^Fp, Chr, Hhd^Fp, Mm, Mv, Mm, Hhd^Fp, Hh^Fp, Hh^Fms, Hh^Fms, Hh^Fms
Hh, Mm, Mm^Xm, Mm^Xm, Hh, Hh, Hh, Hh^Fp, Hh, 4 Hh, Rd, Hh^Fms, Hh^Fp, Hh, Hh^Fms, Hh, Rd, Gs^Fms, Gs^Fds, Gs, Gs, Ss, Wo, Ww, Ww, Hh, Gs^Fds, Gg, Gg, Gs, Gg, Gs^Fms, Gs, Hh, Hh, Hhd, Chr, Hhd^Fp, Hhd^Fp, Mm, Hhd^Fp, Hhd^Fp, Hhd^Fp, Hh^Fms, Hh^Fms, Hh^Fms
Hh, Mm, Mm, Mm, Hh, Hh, Hh, Hh, Hh, Hh, Hh, Rd, Hh, Hh^Fms, Hh^Fms, Gs^Fms, Rd, Gs, Gs, Gs, Gs, Ss, Wo, Wo, Wo, Wo^Ewf, Ww, Gs^Fds, Gg, Gs, Gs^Fds, Gs, Gg, Gs, Hh, Hh, Hhd, Hhd, Hhd, Hhd^Fp, Hhd^Fp, Hhd^Fp, Hhd^Fp, Hhd^Fp, Hh^Fms, Hh^Fms
