border_size=1
usage=map

Rd, Dd, Dd, Dd, Dd, Dd, Hd, Dd, Dd, Dd, Dd, Dd, Qxe, Qxe, Dd, Dd, Dd, Dd, Dd, Dd, Dd, Dd, Gd, Xue, Xue, Xue, Xue, Xue, Xue, Xue, Xol, Xos, Xol, Xu, Xu, Xu, Xu, Xu, Xu, Xu, Xu, Xu, Xu, Xu, Xu, Xos, Xos, Xos, Xos, Xos, Xos, Xos, Xos, Xos, Xos, Xos, Xos, Xos, Xos
Rd, Rd, Rd, Dd, Hd, Dd, Hd, Dd, Hd, Dd, Hd, Hd, Qxe, Dd, Dd, Dd, Dd, Dd, Gd^Ftd, Dd, Gd^Vda, Gd, Hhd^Ftd, Gd, Gd, Hhd, Rd, Rd, Rd, Xue, Cud, Xos, Xos, Xu, Xos, Xu, Uh, Xu, Xu, Xu, Xu, Xu, Xu, Xu, Xu, Xos, Xos, Xos, Xos, Xos, Xos, Xos, Xos, Xos, Xos, Xos, Xos, Xos, Xos
Dd, Rd, Rd, Dd, Kd, Hd, Dd, Hd, Dd, Hd, Dd, Qxe, Dd, Dd, Dd^Ftd, Dd, Hhd, Gd, Gd, Hhd, Wwt, Wwt, Wwt, Gd, Gd^Do, Gd, Dd, Dd, Xue, Rd, Xue, Xos, Urb, Xol, Xol, Xos, Cud, Rb^Br/, Ur^Br\, Uu, Ur^Br\, Uh, Ur, Xu, Xu, Xos, Xos, Xos, Xos, Xos, Xos, Xos, Xos, Xos, Xos, Xos, Xos, Xos, Xos
Dd, Rd, Rd, Rd, Rd, Dd, Dd, Dd, Dd, Dd, Dd, Dd, Dd, Dd, Dd, Dd, Cd, Cd, Gd^Do, Gd^Ftp, Gd^Ftp, Wwt, Wwt, Gd^Vdt, Gd^Ftd, Gd, Dd^Ftd, Dd, Dd, Xue, Xol, Xos, Xos, Urb, Urb, Urb, Xol, Xos, Xu, Ur^Br/, Uu, Ur^Br\, Uu^Br\, Ur, Uh, Uu, Uh, Xos, Xos, Xos, Xos, Xos, Xos, Xos, Xos, Xos, Xos, Xos, Xos
Dd, Dd, Dd, Rd, Rd, Dd, Dd, Dd^Vdt, Dd, Cdr, Rd, Dd, Rd, Dd, Rd, Rd, Rd, Kd, Gd, Gd^Vda, Gd, Wwt, Gd^Do, Gd, Gd^Vda, Gd, Hhd, Dd, Xue, Xue, Xol, Xos, Cud, Xos, Xos, Urb, Urb, Xol, Xos, Xu, Xu, Xu, Xu, Uu^Br\, Ur^Br\, Ur, Ur, Xos, Xos, Xos, Xos, Xos, Xos, Xos, Xos, Xos, Xos, Xos, Xos
Dd, Dd, Dd, Dd, Rd, Rd, Rd, Dd, Rd, Rd, Dd, Rd, Dd, Dd, Dd, Dd, Hhd^Ftd, Cd, Hhd, Gd^Ftd, Xue, Gd, Xue, Hhd, Xue, Xue, Xue, Xue, Xos, Xos, Urb^Dr, Urb, Urb, Urb, Urb, Urb, Xos, Urb, Urb^Dr, Xol, Xol, Xos, Xos, Uh, Xos, Ur^Br\, Xos, Xos, Xos, Xos, Xos, Xos, Xos, Xos, Xos, Xos, Xos, Xos, Xos
Dd, Dd, Dd, Dd, Dd, Rd, Rd, Rd, Rd, Cd, Dd, Dd, Gd^Do, Dd, Dd, Hd, Xue, Xue, Xue, Xue, Xos, Xue, Xos, Xue, Xos, Xos, Xol, Xos, Cud, Urb, Urb, Urb, Cud, Urb, Xos, Xos, Xos, Xos, Xos, Urb, Urb, Xos, Xos, Xos, Xos, Xos, Xos, Xos, Xos, Xos, Xos, Xos, Xos, Xos, Xos, Xos, Xos, Xos, Xos
Dd, Dd, Hd, Dd, Cd, Rd, Rd, Dd, Dd, Dd, Dd, Dd, Gd, Dd, Xos, Xue, Xos, Xos, Xol, Xos, Xos, Xos, Xos, Xos, Xos, Xos, Xol, Cud, Cud^Vud, Cud, Xol, Xos, Xol, Xos, Xol, Xos, Xos, Xos, Xos, Xos, Xos, Urb, Xos, Xos, Xos, Xos, Xos, Xos, Xos, Xos, Xos, Xos, Xos, Xos, Xos, Xos, Xos, Xos, Xos
Dd, Dd, Hd, Dd, Dd, Dd, Dd, Rd, 4 Dd, Dd^Vdt, 5 Dd, Dd, Xos, Xos, Cud, Xos, Xos, Xol, Urb, Urb, Urb^Dr, Rb, Rb, Urb, Urb, Rb^Dr, Rb, Xol, Xol, Xol, Cud^Vud, Cud, Urb, Xol, Rb, Rb, Rb, Rb, Rb, Xos, Xos, Xos, Xos, Cud, Rb, Xos, Xos, 1 Kud, Ur, Xos, Xos, Xos, Ur, Xos, Xos, Xos, Xos, Xos, Xos
Dd, Hd, Hd, Dd, Dd, Dd^Vdt, 2 Dd, 3 Rd, Rd, Rd, Rd, Kd, Xos, Cud, Cud, Cud, Cud^Vud, Urb, Urb, Xos, Rb, Urb, Rb, Urb, Xos, Rb^Dr, Urb, Rb, Urb, Xol, Cud, Urb, Urb, Urb, Cud, Rb^Dr, Xol, Urb, Rb, Rb, Urb, Xos, Xos, Rb, Rb, Qlf, Rb, Xos, Xos, Xos, Ur, Xos, Xos, Xos, Ur, Xos, Xos, Xos, Xos
Dd, Dd, Dd^Do, Dd, Dd, Dd, Dd, Dd, Dd, Rd, Cd, Kd, Rd^Vda, Xos, Xos, Cud, Re, Rb, Rb, Rb, Rb, Urb, Xos, Xos, Ce, Xos, Xos, Urb^Dr, Urb, Urb, Urb, Urb, Cud, Cud, Cud, Urb, Urb, Xol, Xol, Urb, Rb, Rb^Dr, Rb, Rb, Rb^Dr, Qlf, Qlf, Rb^Vud, Rb, Xos, Xos, Xos, Ur, Xos, Xos, Xos, Ur, Xos, Xos
Dd, Dd, Dd, Dd, Dd, Dd, Xos, Xos, Kd, Kd, Rd, Rr, Rr, Rd, Rd, Rd, Re, Rb, Rb^Dr, Rb, Xos, Xos, Ce, Re, Rd, Re, Ce, Xos, Xos, Urb, Urb^Vud, Urb, Cud, Xol, Xol, Urb, Urb, Urb, Urb, Urb, Urb, Urb, Rb^Vud, Rb, Rb, Rb, Qlf, Rb, Rb, Xos, Cud, Xos, Xos, Xos, Ur, Xos, Xos, Xos, Xos
Dd, Hd, Cdr, Dd, Xos, Xos, Xos, Hhd, Gd^Ftd, Cd, Rd, Rd^Vda, Rr, Rd^Vda, Rd, Kd, Kd, Xos, Xos, Xos, Rd, Rd, Re, Rd, Xos, Rd, Re, Re, Rb, Xos, Qlf, Urb, Cud^Vud, Cud, Cud, Xol, Cud, Urb^Vud, Urb, Urb, Urb^Dr, Urb, Rb, Rb^Dr, Rb, Qlf, Cud, Rb, Rb, Rb, Rb^Dr, Cud, Cud, Xos, Xos, Xos, Ur, Xos, Xos
Dd, Hd, Hd, Gd, Xos, Xos, Xos, Gd, Gd^Ftd, Gd^Do, Rd^Vda, Rd, Rd, Rr, Rr, Cd, Kd, Re, Re, Xos, Rd, Rd, Ce, Rd, Rd, Rd, Ce, Rb, Rb, Xos, Qlf, Qlf, Qlf, Cud, Cud^Vud, Cud, Urb, Urb, Urb, Urb, Urb, Rb, Rb, Rb, Rb, Qlf, Qlf, Rb^Br\, Rb^Br\, Rb^Vud, Ur, Rb, Xu, Xos, Xos, Xos, Xos, Xos, Xos
Dd, Dd, Dd, Gd, Xos, Wwt, Wwt, Wwt, Gd, Gd, Rd, Rd, Cd, Rd, Kd, Cd, Rd, Re, Re, Re, Re, Xos, Xos, Re, Ce, Re, Re, Rb, Rb, Rb^Dr, Rb, Qlf, Qlf, Qlf, Qlf, Urb, Urb, Urb^Dr, Qlf, Qlf, Qlf, Rb, Urb, Rb^Dr, Rb, Rb, Rb, Rb, Rb^Dr, Rb^Br\, Rb^Br\, Xu, Xu, Xos, Xos, Xos, Xos, Xos, Xos
Dd, Dd, Gd, Dd, Xos, Wwt, Wwt, Wwt, Cd, Kd, Xos, Cd, Xos, Kd, Hhd, Rr, Rd, Re, Re, Rb^Vda, Re, Re, Re, Xos, Xos, Xos, Rd^Dr, Rd, Rb, Rb^Dr, Rb, Rb, Rb, Qlf, Qlf^Bcx/, Qlf^Bcx/, Qlf, Qlf, Qlf, Qlf, Qlf, Qlf, Qlf, Rb, Rb, Urb^Vud, Rb, Xos, Xos, Rb, Rb^Br|, Ur, Cud, Xu, Xos, Xos, Xos, Xos, Xos
Dd, Dd, Xos, Xos, Chw, Wwt, Gd, Gd^Ftd, Rd, Dd, Ce^Vu, Xos, Xos, Qxe, Qxe, Rr, Rr, Xos, Xos, Re, Re, Re, Xos, Re, Re, Xos, Xos, Rd, Rb, Rb, Rb, Rb, Rb^Vd, Rb, Rb, Qlf, Rb^Edb, Qlf, Rb^Edb, Rb^Vd, Rb^Edb, Qlf, Rb^Edb, Urb, Urb, Urb, Urb, Rb^Dr, Rb, Xos, Rb^Br\, Ur, Uh, Xu, Xu, Xos, Xos, Xos, Xos
Dd, Gd, Xos, Wwf, Xos, Hhd^Ftd, Gd, Ce^Vu, Dd, Ce, Dd, Rd, Rd, Xos, Xos, Hhd, Rr, Rd, Rd, Xos, Xos, Re, Re, Re, Re, Re, Re, Xos, Xos, Rd^Dr, Rb, Rb, Rb, Rb, Rb, Rb^Edb, Rb^Edb, Rb^Edb, Rb^Edb, Xos, Rb^Edb, Rb^Edb, Qlf, Rb^Edb, Xos, Xos, Urb, Rb, Rb, Xos, Cud, Rb^Br\, Ur^Br\, Uu^Vu, Xu, Xos, Xos, Xos, Xos
Xos, Xos, Xos, Wwf, Xos, Gd, Gs^Ftd, Rd, Ch, Gd, Dd, Rd, Ce, Ce^Vu, Rd, Rr, Xos, Rd^Vda, Rd, Xos, Rd, Xos, Xos, Re, Re, Rb^Vda, Re, Re, Re, Xos, Xos, Rb, Rd, Rb, Rb^Vd, Rb^Edb, Qlf, Qlf, Qlf^Bcx/, Rb^Edb, Qlf, Qlf, Qlf, Xos, Rb, Rb, Xos, Urb, Rb, Xos, Rb^Dr, Rb, Ur, Ur^Br\, Uu^Br\, Xu, Xos, Xos, Xos
Xos, Xos, Xos, Wwf, Wwf, Xos, Xos, Ch, Gd, Gs, Hhd, Dd, Xos, Rd, Dd, Rd, Rd, Xos, Xos, Rd, Rd, Rd, Rd, Xos, Xos, Re, Re^Dr, Re, Xos, Re, Re, Xos, Xos, Rd^Dr, Rd, Rd^Dr, Rd, Qlf^Bcx/, Qlf, Qlf, Qlf, Qlf, Hhd, Xos, Xos, Rb, Rb, Urb, Rb, Xos, Xos, Rb, Xos, Ur^Dr, Ur^Br|, Xu, Xu, Xos, Xos
Md, Hhd, Hhd, Xos, Hhd^Ftp, Wwf, Wwf, Wwf, Wwf, Gd^Do, Gs, Gd, Gs^Ftd, Xos, Xos, Cd, Rd, Rd, Rd, Xos, Rd, Rd^Vda, Rd^Dr, Rd, Rd, Xos, Xos, Re, Re, Re, Qxua^Xo, Qxua^Xo, Re, Xos, Rd, Rd, Rd, Rd, Xos, Qlf, Rd, Hhd, Rd, Hhd^Vhh, Rd, Xos, Xos, Rb, Rb, Rb^Dr, Rd, Xos, Xos, Uh, Ur^Br|, Ur, Xu, Xos, Xos
Md, Md, Md, Md, Gd^Ftp, Gs^Ftp, Gs^Ftp, Hhd^Ftp, Wwf, Gs, Gs^Vhc, Gd, Gd^Ftd, Gs, Hhd^Ftd, Xos, Xos, Rd^Dr, Rd, Rd, Rd, Rd, Xos, Rd, Xos, Rd, Rd, Xos, Xos, Qxua^Xo, Re, Rb^Vud, Re, Re, Re, Rd, Xos, Xos, Rd, Hhd, Rd, Rd, Xol, Rd, Rd, Rd, Hhd, Xos, Xos, Rb, Rd, Rd, Rd, Xu, Xu, Uh^Br\, Xu, Xos, Xos
Md, Md, Hhd, Md, Md, Md, Gd^Ftp, Gs, Gd^Ftp, Wwf, Wwt, Gs^Ftp, Xos, Gs, Hhd, Gs^Ftd, Gs, Xos, Xos, Cd, Rd, Rd, Rd, Xos, Xos, Rd, Rd, Rd, Rd, Xos, Rd, Re, Re, Xos, Xos, Re, Re^Dr, Rd, Rd, Rd, Rd, Rd, Rd, Xol, Rd, Rd, Xos, Xos, Rd, Rd, Xu, Rd, Xu, Xu, Uu, Ur^Br|, Xu, Xos, Xos
Md, Md, Gd, Gs, Gd, Gs^Ftp, Xos, Gs, Wwf, Wwt, Wwt, Wwt, Gd^Ftp, Gs, Gd, Md, Gd^Ftd, Gs^Ftd, Gd, Xos, Xos, Rd^Dr, Rd, Rd, Rd, Xos, Rd, Rd, Rd^Dr, Rd, Rd, Xos, Xos, Re, Re, Xos, Re, Re, Re, Xos, Xos, Hhd, Rd, Rd, Rd, Hhd, Xos, Rd, Rd, Xu, Cud^Vud, Xu, Ur, Uu^Vu, Ur^Br/, Ur^Br|, Xu, Xos, Xos
Md, Hhd^Ftp, Gd, Gd^Ftp, Gd, Gs, Gs, Gs, Gs^Ftd, Wwt, Wwt, Wwt, Wwt, Wwt, Gd^Vhc, Xos, Gs^Ftd, Gs, Xol, Xol, Cud, Xol, Xol, Cd, Rd, Rd^Dr, Rd, Rd, Xos, Rd, Xol, Xol, Rrc, Xol, Xol, Re, Re, Rb^Vud, Re, Re, Re, Xos, Xos, Hhd^Vhh, Rd, Rd, Rd, Rd, Hhd^Vhh, Xu, Uh, Ur, Ur^Br/, Ur^Br/, Xu, Xu, Xos, Xos, Xos
Md, Md, Hhd, Gs, Gd, Ce, Gs^Vhc, Gd, Gs, Wot, Wot, Wwt, Wwt, Wwt, Gd, Gd^Ftd, Xol, Xol, Rb, Cud, Cud^Vud, Cud, Cud, Xol, Xol, Rd, Rd, Rd, Rrc, Xol, Rrc, Rrc, Rrc, Rrc, Rrc, Re, Xol, Re, Re, Xos, Xos, Re, Re, Xos, Xos, Hhd, Rd, Rd, Hhd, Xu, Xu, Ur^Br/, Uh, Xu, Xos, Xos, Xos, Xos, Xos
Md, Hhd, Gd, Gd^Ftp, Hhd, Gd, Gs, Gs, Gd, Hhd^Ftd, Ce, Wot, Wwt, Wwt, Wwf, Xos, Rb, Urb, Urb, Urb, Xos, Cud, Cud^Vud, Cud, Cud, Xol, Xol, Rrc, Rrc, Rrc, Rrc^Vhcr, Rrc, Xos, Rrc, Rrc^Vhcr, Rrc, Rrc, Xol, Xos, Re, Re, Xos, Re, Re, Re, Xos, Xos, Rd, Rd, Xu, Uh, Ur^Br|, Xu, Xu, Xu, Xos, Xos, Xos, Xos
Md, Md, Hhd, Gd, Gs, Gd, Xos, Gd^Ftd, Gs^Do, Gs, Gd^Ftp, Wot, Wwt, Chw, Rb^Dr, Xos, Rb, Urb, Rb, Urb, Urb, Urb, Urb, Cud, Xol, Xol, Rrc, Rrc, Xos, Rrc, Rrc, Rrc, Rrc, Rrc, Rrc, Rrc, Xos, Xos, Rd, Rd, Rd, Re, Re, Rb^Vud, Re, Re, Re, Xos, Xos, Xos, Cud, Ur^Br|, Ur^Br\, Uu^Vu, Xu, Xos, Xos, Xos, Xos
Md, Md, Md, Gd^Ftp, Md, Hhd, Gd, Gd^Ftp, Gd, Gs, Wot, Wot, Wwt, Wwf, Wwf, Rb, Rb, Xos, Xos, Urb^Dr, Urb, Urb, Xol, Xol, Rr, Rrc, Rrc, Rrc, Rrc, Rrc, Xos, Rrc, Rrc, Rrc, Rr, Xos, Xos, Rd, Rd, Rd, Rd, Rd, Xos, Re, Re, Xos, Xos, Re, Re, Xos, Xos, Ur^Dr, Ur^Br|, Uh, Xu, Xos, Xos, Xos, Xos
Md, Md, Hhd, Hhd, Xos, Hhd, Gs, Gd, Gs^Vhc, Wot, Wot, Wwt, Chw, Wwf, Xos, Rb^Vu, Rb^Dr, Urb, Urb, Xol, Xol, Xol, Ur, Rr^Dr, Rr, Xos, Rrc, Rrc, Rrc, Rrc, Rrc, Rrc, Xos, Rrc, Rr, Rr^Dr, Ur, Xos, Xos, Rd, Rd, Rd, Rd, Xos, Xos, Re, Re, Xos, Xos, Xos, Re, Xos, Xos, Xos, Xos, Xos, Xos, Xos, Xos
Hhd, Hhd, Xos, Xos, Xos, Md, Gd, Gd, Gs, Wot, Xos, Rb, Wwf, Rb, Rb, Rb, Rb, Rb, Cud, Rb, Ur, Ur, Ur, Ur, Rr, Rrc, Rrc, Xos, Rrc, Rrc^Vhcr, Rr, Rr, Rr, Xos, Xos, Rr, Rr, Ur, Ur^Dr, Xos, Xos, Rd, Rd, Rd, Rd, Xos, Xos, Xos, Re, Xos, Xos, Re, Re, Xos, Xos, Xos, Xos, Xos, Xos
Xos, Xos, Xos, Xos, Xos, Ch, Ch, Md, Ce, Hhd, Xos, Xos, Xos, Rb^Dr, Rb, Rb, Qxua^Bp\, Qxua, Qxua, Urb, Ur^Vhcr, Ur^Dr, Ur, Xos, Ur, Rr^Vhcr, Rrc, Rrc, Xos, Xos, Xos, Rr^Dr, Rr, Rr, Ur, Xos, Xos, Ur, Rr, Ur, Ur, Xos, Xos, Rd, Rd, Rd, Rd, Xos, Xos, Re, Re, Xos, Xos, Xos, Re, Xos, Xos, Xos, Xos
Xos, Xos, Xos, Xos, Xos, Ur, Ur, Xos, Xos, Xos, Ur, Ur^Vud, Xos, Rb, Qxua^Bp\, Qxua, Qxua, Qxua^Bp\, Qxua^Bp\, Qxua, Qxua, Ur, Ur^Dr, Ur, Rr, Rr^Dr, Xos, Xos, Xos, Xos, Ur, Rr, Rr, Ur, Ur^Dr, Rr, Ur, Xos, Xos, Ur, Ur, Ur, Ur, Rd, Rd, Rd, Rd, Rd, Rd, Xos, Xos, Xos, Re, Xos, Xos, Re, Re, Xos, Xos
Xos, Xos, Xos, Xos, Xos, Ur, Ur, Ur, Ur^Dr, Xos, Ur, Xos, Xos, Qxua, Qxua, Qxua^Bp\, Qxua^Bp\, Qxua, Qxua, Qxua^Bp\, Qxua^Bp\, Qxua, Qxua, Ur, Xos, Xos, Xos, Xos, Ur, Ur^Dr, Ur, Rr, Xos, Xos, Xos, Ur, Rr, Ur, Rr, Xos, Xos, Ur, Ur, Ur, Ur, Rd, Xos, Rd, Rd, Rd, Rd, Xos, Xos, Re, Re, Xos, Xos, Xos, Xos
Xos, Xos, Xos, Xos, Xos, Xos, Xos, Ur, Ur, Ur, Xos, Xos, Xos, Xos, Xos, Qxua, Qxua, Qxua^Bp\, Qxua^Bp\, Qxua, Qxua, Qxua^Bp\, Qxua^Bp\, Qxua, Iwr^Dr, Xos, Xos, Rr, Ur^Dr, Ur, Rr, Xos, Xos, Xos, Ur, Ur, Ur, Ur^Dr, Ur, Ur, Ur, Xos, Xos, Ur, Ur, Ur, Ur, Xos, Xos, Rd, Rd, Rd, Rd, Xos, Xos, Xos, Xos, Xos, Xos
Xos, Xos, Xos, Xos, Xos, Xos, Xos, Xos, Ur, Ur, Ur, Ur, Ur, Ur, Ur, Ur, Ur^Vhcr, Qxua, Qxua, Qxua^Bp\, Qxua^Bp\, Qxua, Xos, Iwr, Iwr, Iwr, Iwr, Xos, Xos, Ur, Ur, Ur, Ur, Xos, Xos, Rr, Rr^Dr, Ur, Xos, Rr, Ur, Ur, Ur, Xos, Xos, Ur, Ur, Ur, Ur, Xos, Xos, Rd, Xos, Xos, Xos, Xos, Xos, Xos, Xos
Xos, Xos, Xos, Xos, Xos, Xos, Xos, Xos, Xos, Ur, Wwf, Ur^Dr, Ur, Ur, Ur^Dr, Ur, Ur, Ur, Xos, Qxua, Ur, Ur, Ur, Xos, Xos, Iwr^Dr, Iwr, Iwr, Iwr, Xos, Xos, Rr, Iwr, Iwr^Dr, Iwr, Xos, Xos, Xos, Ur^Dr, Ur, Ur, Ur^Dr, Ur, Ur, Ur, Xos, Xos, Ur, Ur, Ur, Ur, Xos, Xos, Xos, Xos, Xos, Xos, Xos, Xos
Xos, Xos, Xos, Xos, Xos, Xos, Xos, Xos, Xos, Xos, Wwf, Ur, Ur, Xue, Xue, Wwf, Xos, Xos, Xos, Xos, Xos, Ur, Ur^Dr, Ur, Ur, Xos, Xos, Iwr, Iwr, Iwr^Dr, Iwr, Xos, Iwr, Iwr, Xos, Iwr, Xos, Xos, Xos, Ur, Ur, Ur, Xol, Ur, Wwf, Ur, Xol, Ur, Ur, Ur, Xos, Ur, Ur, Xos, Xos, Xos, Xos, Xos, Xos
Xos, Xos, Xos, Xos, Xos, Xos, Xos, Xos, Xos, Xos, Wwf, Wwf, Rb, Xue, Qxe, Xue, Xue, Xue, Xue, Xos, Xue, Xos, Xos, Rb, Rb, Rb, Xos, Xos, Xos, Iwr, Iwr^Dr, Iwr, Iwr, Iwr, Iwr, Iwr, Iwr, Xos, Xos, Xos, Xos, Xol, Wwf, Wwf, Wwf, Wwf, Wwf, Xol, Xol, Ur, Ur, Ur, Ur, Ur, Ur, Xos, Xos, Xos, Xos
Xos, Xos, Xos, Xos, Xos, Xos, Xos, 6 Kud, Cud, Xos, Xos, Uue^Uf, Uue^Uf, Rb, Rb^Dr, Rb^Uf, Rb^Vud, Uue, Rb, Xue, Rb^Dr, Xue, Rb, Rb, Uue, Xos, Xos, Xos, Xos, Xos, Xos, Iwr, Xos, Xos, Xos, Iwr, Iwr^Dr, Iwr, Xos, Xos, Rb, Gll^Ftr, Gll^Ftr, Wwf, Wwf, Wwf, Wwf, Wwf, Wwf, Xol, Xol, Ur, Ur, Ur, Xos, Xos, Xos, Xos, Xos
Xos, Xos, Xos, Xos, Xos, Xos, Xos, Xos, Xos, Xos, Xos, Xue, Xue, Uue, Uue, Rb, Rb, Rb, Uue^Uf, Rb, Xue, Rb, Xue, Xue, Xos, Xos, Xos, Xos, Xos, Xos, Xos, Xos, Xos, Xos, Xos, Iwr, Iwr, Iwr, Xos, Xos, Xos, Rb, Rb, Gll^Ftr, Gll^Ftr, Wwf, Wwf, Wwf, Xos, Xos, Xos, Xos, Xos, Xos, Xos, Xos, Xos, Xos, Xos
Xos, Xos, Xos, Xos, Xos, Xos, Xos, Xos, Xos, Xos, Xos, Xue, Xue, Xue, Xue, Xue, Xue, Xue, Xue, Xue, Xue, Xue, Xue, Xue, Xos, Xos, Xos, Xos, Xos, Xos, Xos, Xos, Xos, Xos, Xos, Xos, Xos, Xos, Xos, Xos, Xos, Xos, Xos, Xos, Xos, Xos, Xos, Xos, Xos, Xos, Xos, Xos, Xos, Xos, Xos, Xos, Xos, Xos, Xos
