border_size=1
usage=map

Dd, Dd, Dd, Dd, Dd, Dd, Dd, Dd, Dd, Dd, Xos, Xos, Xos, Xos, Xos, Xos, Xos, Xos, Xos, Xos, Xos, Xos, Xos, Xos, Xos, Xos, Xos, Xos, Xos, Xos, Xos, Xos, Xos, Xos, Xos, Xos, Xos, Xos, Xos, Xos, Xos, Xos, Xos, Xos, Xos, Xos, Xos, Xos, Xos, Xos, Xos, Xos, Xos, Xos, Xos
Dd, Dd, Dd, Dd, 4 Dd, Dd, 5 Dd, Dd, Xos, Xos, Cud, Xos, Xos, Xos, Urb, Urb, Urb, Urb, Urb, Urb, Urb, Urb, Urb, Xos, Xos, Xos, Ur, Ur, Ur, Xos, Xos, Ur, Ur, Ur, Xos, Xos, Xos, Xos, Xos, Xos, Ur, Xos, Xos, 1 Kud, Ur, Xos, Xos, Xos, Ur, Xos, Xos, Xos, Xos, Xos, Xos
Dd, Dd, 2 Dd, 3 Rd, Rd, Rd, Rd, Xos, Xos, Cud, Cud, Cud, Cud, Xos, Xos, Urb, Urb, Urb, Urb, Urb, Xos, Urb, Urb, Urb, Urb, Xos, Xos, Ur, Ur, Ur, Ur, Xos, Xos, Xos, Ur, Ur, Ur, Xos, Xos, Ur, Ur, Ur, Ur, Xos, Xos, Xos, Ur, Xos, Xos, Xos, Ur, Xos, Xos, Xos, Xos
Dd, Dd, Dd, Dd, Dd, Xos, Xos, Rd, Rd, Xos, Xos, Cud, Rd, Rd, Rd, Xos, Urb, Urb, Xos, Xos, Rd, Xos, Xos, Urb, Urb, Urb, Urb, Xos, Xos, Ur, Xos, Xos, Ur, Xos, Xos, Ur, Ur, Ur, Ur, Xos, Xos, Ur, Xos, Xos, Ur, Xos, Xos, Xos, Ur, Xos, Xos, Xos, Ur, Xos, Xos
Dd, Dd, Xos, Xos, Xos, Rd, Rd, Xos, Rd, Re, Re, Xos, Rd, Rd, Rd, Rd, Xos, Xos, Rd, Rd, Rd, Rd, Rd, Xos, Xos, Urb, Urb, Urb, Xos, Xos, Xos, Ur, Ur, Ur, Ur, Xos, Xos, Ur, Ur, Ur, Xos, Xos, Xos, Ur, Ur, Xos, Ur, Xos, Xos, Xos, Ur, Xos, Xos, Xos, Xos
Xos, Xos, Rd, Rd, Rd, Xos, Xos, Rd, Rd, Rb^Vud, Re, Re, Re, Xos, Xos, Xos, Rd, Rd, Rd, Rd, Xos, Rd, Rd, Rd, Rd, Xos, Xos, Xos, Ur, Ur, Ur, Xos, Xos, Ur, Ur, Ur, Ur, Xos, Xos, Xos, Ur, Ur, Ur, Xos, Xos, Xos, Ur, Ur, Ur, Xos, Xos, Xos, Ur, Xos, Xos
Xos, Xos, Xos, Rd, Rd, Rd, Rd, Xos, Rd, Re, Re, Xos, Xos, Re, Re, Xos, Rd, Rd, Rd, Rd, Rd, Rd, Rd, Rd, Rd, Xos, Rd, Xos, Xos, Ur, Ur, Ur, Ur, Xos, Xos, Ur, Xos, Xos, Ur, Xos, Xos, Ur, Ur, Ur, Ur, Xos, Xos, Ur, Xos, Xos, Xos, Xos, Xos, Xos, Xos
Xos, Rd, Rd, Xos, Xos, Rd, Rd, Rd, Rd, Xos, Xos, Re, Re, Xos, Re, Re, Re, Xos, Xos, Rd, Rd, Rd, Rd, Rd, Xos, Rd, Rd, Rd, Rd, Xos, Xos, Ur, Ur, Ur, Xos, Xos, Xos, Ur, Ur, Ur, Ur, Xos, Xos, Ur, Ur, Xos, Ur, Xos, Xos, Xos, Xos, Xos, Xos, Xos, Xos
Xos, Rd, Rd, Rd, Rd, Xos, Xos, Rd, Xos, Xos, Rd, Xos, Rd, Re, Re, Rb^Vud, Re, Re, Re, Xos, Xos, Xos, Rd, Rd, Rd, Xos, Xos, Rd, Rd, Rd, Rd, Xos, Xos, Xos, Ur, Ur, Ur, Xos, Xos, Ur, Ur, Ur, Ur, Xos, Xos, Xos, Ur, Ur, Ur, Xos, Xos, Xos, Xos, Xos, Xos
Xos, Xos, Xos, Rd, Rd, Rd, Rd, Xos, Xos, Rd, Rd, Rd, Rd, Xos, Xos, Re, Re, Xos, Xos, Re, Re, Xos, Xos, Rd, Rd, Rd, Rd, Xos, Xos, Rd, Xos, Xos, Rd, Xos, Xos, Ur, Ur, Ur, Ur, Xos, Xos, Ur, Xos, Xos, Ur, Xos, Xos, Ur, Xos, Xos, Xos, Xos, Xos, Xos, Xos
Xos, Rd, Rd, Rd, Xos, Xos, Rd, Rd, Rd, Xos, Xos, Rd, Rd, Rd, Rd, Xos, Xos, Re, Re, Xos, Re, Re, Re, Xos, Xos, Rd, Rd, Rd, Xos, Xos, Xos, Rd, Rd, Rd, Rd, Xos, Xos, Ur, Ur, Ur, Xos, Xos, Xos, Ur, Ur, Xos, Ur, Xos, Xos, Xos, Xos, Xos, Xos, Xos, Xos
Xos, Rd, Rd, Rd, Rd, Xos, Xos, Rd, Rd, Rd, Rd, Rd, Xos, Rd, Rd, Xos, Rd, Xos, Xos, Re, Re, Rb^Vud, Re, Re, Re, Xos, Xos, Xos, Rd, Rd, Rd, Xos, Xos, Rd, Rd, Rd, Rd, Xos, Xos, Xos, Ur, Ur, Ur, Xos, Xos, Xos, Ur, Ur, Ur, Xos, Xos, Xos, Xos, Xos, Xos
Xos, Xos, Xos, Rd, Rd, Rd, Gs, Xos, Xos, Rd, Rd, Rd, Rd, Xos, Xos, Rd, Rd, Rd, Rd, Xos, Xos, Re, Re, Xos, Xos, Re, Re, Xos, Xos, Rd, Rd, Rd, Rd, Xos, Xos, Rd, Xos, Xos, Ur, Xos, Xos, Ur, Ur, Ur, Ur, Xos, Xos, Ur, Xos, Xos, Xos, Xos, Xos, Xos, Xos
Xos, Gs^Ftp, Gs^Ftp, Xos, Xos, Gd, Gs, Gd, Gs^Ftd, Xos, Xos, Xos, Rd, Rd, Rd, Xos, Xos, Rd, Rd, Rd, Rd, Xos, Xos, Re, Re, Xos, Qxua^Xo, Qxua^Xo, Re, Xos, Xos, Rd, Rd, Rd, Xos, Xos, Xos, Ur, Ur, Ur, Ur, Xos, Xos, Ur, Ur, Xos, Ur, Xos, Xos, Xos, Xos, Xos, Xos, Xos, Xos
Xos, Gd^Ftp, Gs^Ftp, Gd^Ftp, Gs, Gs, Gs, Gd, Gd^Ftd, Gs, Gd^Ftd, Xos, Xos, Rd, Rd, Rd, Rd, Xos, Xos, Rd, Xos, Rd, Rd, Xos, Xos, Qxua^Xo, Re, Rb^Vud, Re, Re, Re, Xos, Xos, Xos, Ur, Ur, Ur, Xos, Xos, Ur, Ur, Ur, Ur, Xos, Xos, Xos, Ur, Ur, Ur, Xos, Xos, Xos, Xos, Xos, Xos
Xos, Gs^Ftp, Gd^Ftp, Gs, Gd^Ftp, Wwt, Wwt, Gs^Ftp, Xos, Gs, Gd, Gs^Ftd, Gs, Xos, Xos, Rd, Rd, Rd, Rd, Xos, Xos, Rd, Rd, Rd, Rd, Xos, Rd, Re, Re, Xos, Xos, Re, Re, Xos, Xos, Ur, Ur, Ur, Ur, Xos, Xos, Ur, Xos, Xos, Ur, Xos, Xos, Ur, Xos, Xos, Xos, Xos, Xos, Xos, Xos
Xos, Gs^Ftp, Xos, Gs, Wwt, Wwt, Wwt, Wwt, Gd^Ftp, Gs, Gd, Gs, Gd^Ftd, Gs^Ftd, Gd, Xos, Xos, Xos, Rd, Rd, Rd, Xos, Xos, Rd, Rd, Rd, Rd, Xos, Xos, Re, Re, Xos, Re, Re, Re, Xos, Xos, Ur, Ur, Ur, Xos, Xos, Xos, Ur, Ur, Xos, Ur, Xos, Xos, Xos, Xos, Xos, Xos, Xos, Xos
Xos, Gd, Gs, Gd, Gs^Ftd, Wwt, Wwt, Wwt, Wwt, Wwt, Gd, Xos, Gs^Ftd, Gs, Xos, Xos, Ur, Xos, Xos, Rd, Rd, Rd, Rd, Xos, Xos, Rd, Xos, Xos, Ur, Xos, Xos, Re, Re, Rb^Vud, Re, Re, Re, Xos, Xos, Xos, Ur, Ur, Ur, Xos, Xos, Xos, Ur, Ur, Ur, Xos, Xos, Xos, Xos, Xos, Xos
Xos, Xos, Xos, Gd, Gs, Wot, Wot, Wwt, Wwt, Wwt, Gd, Gd^Ftd, Xos, Xos, Xos, Ur, Ur, Ur, Ur, Xos, Xos, Rd, Rd, Rd, Xos, Xos, Xos, Ur, Ur, Ur, Ur, Xos, Xos, Re, Re, Xos, Xos, Re, Re, Xos, Xos, Ur, Ur, Ur, Ur, Xos, Xos, Ur, Xos, Xos, Xos, Xos, Xos, Xos, Xos
Xos, Ur, Ur, Xos, Xos, Gd^Ftd, Gs, Wot, Wwt, Wwt, Xos, Xos, Ur, Ur, Ur, Xos, Xos, Ur, Ur, Ur, Ur, Xos, Xos, Xos, Ur, Ur, Ur, Xos, Xos, Ur, Ur, Ur, Ur, Xos, Xos, Re, Re, Xos, Re, Re, Re, Xos, Xos, Ur, Ur, Xos, Ur, Xos, Xos, Xos, Xos, Xos, Xos, Xos, Xos
Xos, Ur, Ur, Ur, Ur, Xos, Xos, Wot, Xos, Xos, Ur, Xos, Xos, Ur, Ur, Ur, Ur, Xos, Xos, Ur, Xos, Xos, Ur, Xos, Xos, Ur, Ur, Ur, Ur, Xos, Xos, Ur, Xos, Xos, Ur, Xos, Xos, Re, Re, Rb^Vud, Re, Re, Re, Xos, Xos, Xos, Ur, Ur, Ur, Xos, Xos, Xos, Xos, Xos, Xos
Xos, Xos, Xos, Ur, Ur, Ur, Xos, Xos, Xos, Ur, Ur, Ur, Ur, Xos, Xos, Ur, Ur, Ur, Xos, Xos, Xos, Ur, Ur, Ur, Ur, Xos, Xos, Ur, Ur, Ur, Xos, Xos, Xos, Ur, Ur, Ur, Ur, Xos, Xos, Re, Re, Xos, Xos, Re, Re, Xos, Xos, Ur, Xos, Xos, Xos, Xos, Xos, Xos, Xos
Xos, Ur, Ur, Xos, Xos, Xos, Ur, Ur, Ur, Xos, Xos, Ur, Ur, Ur, Ur, Xos, Xos, Xos, Ur, Ur, Ur, Xos, Xos, Ur, Ur, Ur, Ur, Xos, Xos, Xos, Ur, Ur, Ur, Xos, Xos, Ur, Ur, Ur, Ur, Xos, Xos, Re, Re, Xos, Xos, Xos, Re, Xos, Xos, Xos, Xos, Xos, Xos, Xos, Xos
Xos, Ur, Xos, Xos, Ur, Xos, Xos, Ur, Ur, Ur, Ur, Xos, Xos, Ur, Xos, Xos, Ur, Xos, Xos, Ur, Ur, Ur, Ur, Xos, Xos, Ur, Xos, Xos, Ur, Xos, Xos, Ur, Ur, Ur, Ur, Xos, Xos, Ur, Ur, Ur, Ur, Xos, Xos, Xos, Re, Xos, Xos, Re, Re, Xos, Xos, Xos, Xos, Xos, Xos
Xos, Xos, Xos, Ur, Ur, Ur, Xos, Xos, Xos, Ur, Ur, Ur, Xos, Xos, Xos, Ur, Ur, Ur, Xos, Xos, Xos, Ur, Ur, Ur, Xos, Xos, Xos, Ur, Ur, Ur, Xos, Xos, Xos, Ur, Ur, Ur, Xos, Xos, Xos, Ur, Ur, Ur, Xos, Xos, Xos, Re, Re, Xos, Xos, Xos, Re, Xos, Xos, Xos, Xos
Xos, Xos, Xos, Xos, Xos, Xos, Xos, Xos, Xos, Xos, Xos, Xos, Xos, Xos, Xos, Xos, Xos, Xos, Xos, Xos, Xos, Xos, Xos, Xos, Xos, Xos, Xos, Xos, Xos, Xos, Xos, Xos, Xos, Xos, Xos, Xos, Xos, Xos, Xos, Xos, Xos, Xos, Xos, Xos, Xos, Xos, Xos, Xos, Re, Xos, Xos, Re, Re, Xos, Xos
Xos, Xos, Xos, Xos, Xos, Xos, Xos, Xos, Xos, Xos, Xos, Xos, Xos, Xos, Xos, Xos, Xos, Xos, Xos, Xos, Xos, Xos, Xos, Xos, Xos, Xos, Xos, Xos, Xos, Xos, Xos, Xos, Xos, Xos, Xos, Xos, Xos, Xos, Xos, Xos, Xos, Xos, Xos, Xos, Xos, Xos, Xos, Xos, Xos, Re, Re, Xos, Xos, Xos, Xos
Xos, Xos, Xos, Xos, Xos, Xos, Xos, Xos, Xos, Xos, Xos, Xos, Xos, Xos, Xos, Xos, Xos, Xos, Xos, Xos, Xos, Xos, Xos, Xos, Xos, Xos, Xos, Xos, Xos, Xos, Xos, Xos, Xos, Xos, Xos, Xos, Xos, Xos, Xos, Xos, Xos, Xos, Xos, Xos, Xos, Xos, Xos, Xos, Xos, Xos, Xos, Xos, Xos, Xos, Xos
Xos, Xos, Xos, Xos, Xos, Xos, Xos, Xos, Xos, Xos, Xos, Xos, Xos, Xos, Xos, Xos, Xos, Xos, Xos, Xos, Xos, Xos, Xos, Xos, Xos, Xos, Xos, Xos, Xos, Xos, Xos, Xos, Xos, Xos, Xos, Xos, Xos, Xos, Xos, Xos, Xos, Xos, Xos, Xos, Xos, Xos, Xos, Xos, Xos, Xos, Xos, Xos, Xos, Xos, Xos
Xos, Xos, Xos, Xos, Xos, Xos, Xos, Xos, Xos, Xos, Xos, Xos, Xos, Xos, Xos, Xos, Xos, Xos, Xos, Xos, Xos, Xos, Xos, Xos, Xos, Xos, Xos, Xos, Xos, Xos, Xos, Xos, Xos, Xos, Xos, Xos, Xos, Xos, Xos, Xos, Xos, Xos, Xos, Xos, Xos, Xos, Xos, Xos, Xos, Xos, Xos, Xos, Xos, Xos, Xos
Xos, Xos, Xos, Xos, Xos, Xos, Xos, Xos, Xos, Xos, Xos, Xos, Xos, Xos, Xos, Xos, Xos, Xos, Xos, Xos, Xos, Xos, Xos, Xos, Xos, Xos, Xos, Xos, Xos, Xos, Xos, Xos, Xos, Xos, Xos, Xos, Xos, Xos, Xos, Xos, Xos, Xos, Xos, Xos, Xos, Xos, Xos, Xos, Xos, Xos, Xos, Xos, Xos, Xos, Xos
Xos, Xos, Xos, Xos, Xos, Xos, Xos, Xos, Xos, Xos, Xos, Xos, Xos, Xos, Xos, Xos, Xos, Xos, Xos, Xos, Xos, Xos, Xos, Xos, Xos, Xos, Xos, Xos, Xos, Xos, Xos, Xos, Xos, Xos, Xos, Xos, Xos, Xos, Xos, Xos, Xos, Xos, Xos, Xos, Xos, Xos, Xos, Xos, Xos, Xos, Xos, Xos, Xos, Xos, Xos
Xos, Xos, Xos, 6 Kud, Cud, Xos, Xos, Xos, Xos, Xos, Xos, Xos, Xos, Xos, Xos, Xos, Xos, Xos, Xos, Xos, Xos, Xos, Xos, Xos, Xos, Xos, Xos, Xos, Xos, Xos, Xos, Xos, Xos, Xos, Xos, Xos, Xos, Xos, Xos, Xos, Xos, Xos, Xos, Xos, Xos, Xos, Xos, Xos, Xos, Xos, Xos, Xos, Xos, Xos, Xos
Xos, Xos, Xos, Xos, Xos, Xos, Xos, Xos, Xos, Xos, Xos, Xos, Xos, Xos, Xos, Xos, Xos, Xos, Xos, Xos, Xos, Xos, Xos, Xos, Xos, Xos, Xos, Xos, Xos, Xos, Xos, Xos, Xos, Xos, Xos, Xos, Xos, Xos, Xos, Xos, Xos, Xos, Xos, Xos, Xos, Xos, Xos, Xos, Xos, Xos, Xos, Xos, Xos, Xos, Xos
Xos, Xos, Xos, Xos, Xos, Xos, Xos, Xos, Xos, Xos, Xos, Xos, Xos, Xos, Xos, Xos, Xos, Xos, Xos, Xos, Xos, Xos, Xos, Xos, Xos, Xos, Xos, Xos, Xos, Xos, Xos, Xos, Xos, Xos, Xos, Xos, Xos, Xos, Xos, Xos, Xos, Xos, Xos, Xos, Xos, Xos, Xos, Xos, Xos, Xos, Xos, Xos, Xos, Xos, Xos
