border_size=1
usage=map

Dd, Dd, Dd, Dd, Dd, Dd, Dd, Dd, Dd, Dd, Xos, Xos, Xos, Xos, Xos, Xos, Xos, Xos, Xos, Xos, Xos, Xos, Xos, Xos, Xos, Xos, Xos, Xos, Xos, Xos, Xos, Xos, Xos, Xos, Xos, Xos, Xos, Xos, Xos, Xos, Xos, Xos, Xos, Xos, Xos, Xos, Xos, Xos, Xos, Xos, Xos, Xos, Xos, Xos, Xos
Dd, Dd, Dd, Dd, 4 Dd, Dd, 5 Dd, Dd, Xos, Xos, Cud, Xos, Xos, Xos, Urb, Urb, Urb, Rb, Rb, Urb, Urb, Rb, Rb, Xos, Xos, Xos, Cud, Cud, Urb, Xos, Rb, Rb, Rb, Rb, Rb, Xos, Xos, Xos, Xos, Xos, Ur, Xos, Xos, 1 Kud, Ur, Xos, Xos, Xos, Ur, Xos, Xos, Xos, Xos, Xos, Xos
Dd, Dd^Vdt, 2 Dd, 3 Rd, Rd, Rd, Rd, Xos, Xos, Cud, Cud, Cud, Cud, Xos, Xos, Urb, Rb, Urb, Rb, Urb, Xos, Rb, Urb, Rb, Urb, Xos, Cud, Urb, Urb, Urb, Cud, Rb, Xos, Rb, Rb, Rb, Rb, Xos, Xos, Ur, Ur, Ur, Ur, Xos, Xos, Xos, Ur, Xos, Xos, Xos, Ur, Xos, Xos, Xos, Xos
Dd, Dd, Dd, Dd, Dd, Rd, Xos, Rd, Rd, Xos, Xos, Cud, Rb, Rb, Rb, Rb, Rb, Urb, Xos, Xos, Rd, Xos, Xos, Urb, Urb, Urb, Urb, Urb, Cud, Cud, Cud, Urb, Urb, Xos, Xos, Rb, Rb, Rb, Rb, Xos, Xos, Ur, Xos, Xos, Ur, Xos, Xos, Xos, Ur, Xos, Xos, Xos, Ur, Xos, Xos
Dd, Dd, Xos, Xos, Xos, Rd, Rd, Rd, Cd, Rd, Re, Rb, Rb, Rb, Rb, Rb, Xos, Xos, Rd, Rd, Rd, Rd, Rd, Xos, Xos, Urb, Urb, Urb, Cud, Xol, Xol, Urb, Urb, Urb, Urb, Xos, Xos, Rb, Rb, Rb, Xos, Xos, Xos, Ur, Ur, Xos, Ur, Xos, Xos, Xos, Ur, Xos, Xos, Xos, Xos
Xos, Xos, Rd, Rd, Rd, Xos, Xos, Rd, Cd, Rd^Vda, Re, Re, Rb, Xos, Xos, Xos, Rd, Rd, Rd, Rd, Xos, Rd, Rd, Rd, Rd, Xos, Xos, Urb, Cud, Cud, Cud, Xol, Cud, Urb, Urb, Urb, Urb, Xos, Xos, Xos, Ur, Ur, Ur, Xos, Xos, Xos, Ur, Ur, Ur, Xos, Xos, Xos, Ur, Xos, Xos
Xos, Xos, Xos, Rd, Rd, Rd, Rd^Vda, Rd, Rd, Cd, Re, Re, Xos, Re, Re, Xos, Rd, Rd, Rd, Rd, Rd, Rd, Rd, Rd, Rd, Xos, Qlf, Xos, Xos, Cud, Cud, Cud, Urb, Urb, Urb, Urb, Rb, Rb, Rb, Xos, Xos, Ur, Ur, Ur, Ur, Xos, Xos, Ur, Xos, Xos, Xos, Xos, Xos, Xos, Xos
Xos, Rd, Rd, Xos, Xos, Rd, Rd, Rd, Rd, Xos, Xos, Re, Re, Re, Re, Re, Re, Xos, Xos, Rd, Rd, Rd, Rd, Rd, Xos, Rb, Rb, Qlf, Qlf, Xos, Xos, Urb, Urb, Urb, Xos, Xos, Xos, Rb, Rb, Rb, Rb, Xos, Xos, Ur, Ur, Xos, Ur, Xos, Xos, Xos, Xos, Xos, Xos, Xos, Xos
Xos, Rd, Rd, Rd, Rd, Xos, Xos, Rd, Xos, Xos, Rd, Xos, Rd, Re, Re, Rb^Vda, Re, Re, Re, Xos, Xos, Xos, Rd, Rd, Rd, Xos, Xos, Rb, Rb^Vd, Qlf, Qlf, Xos, Xos, Xos, Qlf, Qlf, Qlf, Xos, Xos, Rb, Rb, Rb, Rb, Xos, Xos, Xos, Ur, Ur, Ur, Xos, Xos, Xos, Xos, Xos, Xos
Xos, Xos, Xos, Rd, Rd, Rd, Rd, Xos, Xos, Rd, Rd, Rd, Rd, Xos, Xos, Re, Re, Re, Xos, Re, Re, Xos, Xos, Rd, Rd, Rd, Rd, Xos, Xos, Rb, Rb, Qlf, Rb, Qlf, Rb, Rb^Vd, Rb, Qlf, Rb, Rb, Rb, Rb, Rb, Rb, Rb, Xos, Xos, Ur, Xos, Xos, Xos, Xos, Xos, Xos, Xos
Xos, Rd, Rd, Rd, Xos, Xos, Rd, Rd, Rd, Xos, Xos, Rd, Rd, Rd, Rd, Xos, Xos, Re, Re, Re, Re, Re, Re, Xos, Xos, Rd, Rd, Rd, Rd, Xos, Xos, Rb, Qlf, Rb, Rb, Xos, Rb, Rb, Qlf, Rb, Xos, Xos, Rb, Rb, Rb, Xos, Ur, Xos, Xos, Xos, Xos, Xos, Xos, Xos, Xos
Xos, Rd, Rd, Rd, Rd, Xos, Xos, Rd, Rd, Rd, Rd, Rd, Xos, Rd, Rd, Xos, Rd, Xos, Xos, Re, Re, Rb^Vda, Re, Re, Re, Xos, Xos, Rd, Rd, Rd, Rd, Xos, Xos, Qlf, Qlf, Rb, Qlf, Qlf, Xos, Xos, Rb, Rb, Xos, Rb, Rb, Xos, Ur, Ur, Ur, Xos, Xos, Xos, Xos, Xos, Xos
Xos, Xos, Xos, Rd, Rd, Rd, Hhd, Xos, Xos, Rd, Rd, Rd, Rd, Xos, Xos, Rd, Rd, Rd, Rd, Xos, Xos, Re, Re, Re, Xos, Re, Re, Xos, Xos, Rd, Rd, Rd, Rd, Xos, Xos, Qlf, Xos, Xos, Hhd, Xos, Xos, Rb, Rb, Rb, Rb, Xos, Xos, Ur, Xos, Xos, Xos, Xos, Xos, Xos, Xos
Xos, Hhd^Ftp, Gs^Ftp, Xos, Xos, Gd, Gs, Gd, Gs^Ftd, Xos, Xos, Rd, Rd, Rd, Rd, Xos, Xos, Rd, Rd, Rd, Rd, Xos, Xos, Re, Re, Re, Qxua^Xo, Qxua^Xo, Re, Xos, Rd, Rd, Rd, Rd, Xos, Xos, Rd, Hhd, Rd, Hhd, Rd, Xos, Xos, Rb, Rb, Rb, Rd, Xos, Xos, Xos, Xos, Xos, Xos, Xos, Xos
Xos, Gd^Ftp, Gs^Ftp, Hhd^Ftp, Gs, Gs, Gs^Vhc, Gd, Gd^Ftd, Gs, Hhd^Ftd, Xos, Xos, Rd, Rd, Rd, Rd, Xos, Xos, Rd, Xos, Rd, Rd, Xos, Xos, Qxua^Xo, Re, Rb^Vud, Re, Re, Re, Rd, Xos, Xos, Rd, Hhd, Rd, Rd, Xol, Rd, Rd, Rd, Hhd, Xos, Xos, Rb, Rd, Rd, Rd, Xos, Xos, Xos, Xos, Xos, Xos
Xos, Gs^Ftp, Gd^Ftp, Gs, Gd^Ftp, Wwf, Wwt, Gs^Ftp, Xos, Gs, Hhd, Gs^Ftd, Gs, Xos, Xos, Rd, Rd, Rd, Rd, Xos, Xos, Rd, Rd, Rd, Rd, Xos, Rd, Re, Re, Xos, Xos, Re, Re, Rd, Rd, Rd, Rd, Rd, Rd, Xol, Rd, Rd, Xos, Xos, Rd, Rd, Xos, Rd, Xos, Xos, Xos, Xos, Xos, Xos, Xos
Xos, Gs^Ftp, Xos, Gs, Wwf, Wwt, Wwt, Wwt, Gd^Ftp, Gs, Gd, Gs, Gd^Ftd, Gs^Ftd, Gd, Xos, Xos, Rd, Rd, Rd, Rd, Xos, Xos, Rd, Rd, Rd, Rd, Xos, Xos, Re, Re, Xos, Re, Re, Re, Xos, Xos, Hhd, Rd, Rd, Rd, Hhd, Xos, Rd, Rd, Xos, Ur, Xos, Xos, Xos, Xos, Xos, Xos, Xos, Xos
Xos, Gd, Gs, Gs, Gs^Ftd, Wwt, Wwt, Wwt, Wwt, Wwt, Gd^Vhc, Xos, Gs^Ftd, Gs, Xol, Xol, Cud, Xol, Xol, Rd, Rd, Rd, Rd, Xos, Xos, Rd, Xos, Xos, Rd, Xos, Xos, Re, Re, Rb^Vud, Re, Re, Re, Xos, Xos, Hhd, Rd, Rd, Rd, Rd, Hhd, Xos, Ur, Ur, Ur, Xos, Xos, Xos, Xos, Xos, Xos
Xos, Ce, Gs^Vhc, Gd, Gs, Wot, Wot, Wwt, Wwt, Wwt, Gd, Gd^Ftd, Xol, Xol, Rb, Cud, Cud^Vud, Cud, Cud, Xol, Xol, Rd, Rd, Rd, Rd, Xos, Rd, Rd, Rd, Rd, Rd, Rd, Xos, Re, Re, Xos, Xos, Re, Re, Xos, Xos, Hhd, Rd, Rd, Hhd, Xos, Xos, Ur, Xos, Xos, Xos, Xos, Xos, Xos, Xos
Xos, Gd, Gs, Gs, Gd, Hhd^Ftd, Ce, Wot, Wwt, Wwt, Wwf, Xos, Rb, Urb, Urb, Urb, Xos, Cud, Cud^Vud, Cud, Cud, Xol, Xos, Rd, Rd, Rd, Rd, Rd, Xos, Rd, Rd, Rd, Rd, Xos, Xos, Re, Re, Xos, Re, Re, Re, Xos, Xos, Rd, Rd, Xos, Ur, Xos, Xos, Xos, Xos, Xos, Xos, Xos, Xos
Xos, Gd, Xos, Gd^Ftd, Gs, Gs, Gd^Ftp, Wot, Wwt, Wwt, Rb^Dr, Xos, Rb, Urb, Rb, Urb, Urb, Urb, Urb, Cud, Xos, Xos, Ur, Xos, Xos, Rd, Rd, Rd, Rd, Rd, Rd, Rd, Xos, Xos, Rd, Rd, Rd, Re, Re, Rb^Vud, Re, Re, Re, Xos, Xos, Xos, Ur, Ur, Ur, Xos, Xos, Xos, Xos, Xos, Xos
Xos, Hhd, Gd, Gd^Ftp, Gd, Gs, Wot, Wot, Wwt, Wwf, Wwf, Rb, Rb, Xos, Xos, Urb^Dr, Urb, Urb, Xol, Xos, Xos, Ur, Ur, Ur, Ur, Ur, Xos, Rd, Rd, Rd, Xos, Xos, Xos, Rd, Rd, Rd, Rd, Rd, Xos, Re, Re, Xos, Xos, Re, Re, Xos, Xos, Ur, Xos, Xos, Xos, Xos, Xos, Xos, Xos
Xos, Hhd, Gs, Gd, Gs^Vhc, Wot, Wot, Wwt, Wwf, Wwf, Xos, Rb, Rb^Dr, Rb, Ur, Xos, Xol, Xol, Ur, Ur, Ur, Xos, Xos, Ur, Ur, Ur, Ur, Xos, Xos, Xos, Ur, Ur, Ur, Xos, Xos, Rd, Rd, Rd, Rd, Xos, Xos, Re, Re, Xos, Xos, Xos, Re, Xos, Xos, Xos, Xos, Xos, Xos, Xos, Xos
Xos, Gs, Gd, Gd, Gs, Wot, Xos, Rb, Wwf, Rb, Rb, Rb, Rb, Rb, Ur, Ur, Ur, Ur, Ur, Ur, Ur, Ur, Ur, Xos, Xos, Ur, Xos, Xos, Ur, Xos, Xos, Ur, Ur, Ur, Ur, Xos, Xos, Rd, Rd, Rd, Rd, Xos, Xos, Xos, Re, Xos, Xos, Re, Re, Xos, Xos, Xos, Xos, Xos, Xos
Xos, Xos, Xos, Gs, Ce, Hhd, Xos, Xos, Xos, Rb^Dr, Rb, Rb, Qxua^Bp\, Qxua, Qxua, Ur, Ur, Ur, Ur, Xos, Ur, Ur, Ur, Ur, Xos, Xos, Xos, Ur, Ur, Ur, Xos, Xos, Xos, Ur, Ur, Ur, Xos, Xos, Xos, Rd, Rd, Rd, Xos, Xos, Xos, Re, Re, Xos, Xos, Xos, Re, Xos, Xos, Xos, Xos
Xos, Xos, Xos, Xos, Xos, Xos, Xos, Xos, Xos, Rb, Qxua^Bp\, Qxua, Qxua, Qxua^Bp\, Qxua^Bp\, Qxua, Qxua, Ur, Ur, Ur, Ur, Ur, Xos, Xos, Xos, Xos, Xos, Xos, Xos, Xos, Xos, Xos, Xos, Xos, Xos, Xos, Xos, Xos, Xos, Xos, Xos, Xos, Xos, Xos, Xos, Xos, Xos, Xos, Re, Xos, Xos, Re, Re, Xos, Xos
Xos, Xos, Xos, Xos, Xos, Xos, Xos, Xos, Xos, Qxua, Qxua, Qxua^Bp\, Qxua^Bp\, Qxua, Qxua, Qxua^Bp\, Qxua^Bp\, Qxua, Xos, Ur, Xos, Xos, Xos, Xos, Xos, Xos, Xos, Xos, Xos, Xos, Xos, Xos, Xos, Xos, Xos, Xos, Xos, Xos, Xos, Xos, Xos, Xos, Xos, Xos, Xos, Xos, Xos, Xos, Xos, Re, Re, Xos, Xos, Xos, Xos
Xos, Xos, Xos, Xos, Xos, Xos, Xos, Xos, Xos, Xos, Xos, Qxua, Qxua, Qxua^Bp\, Qxua^Bp\, Qxua, Xos, Xos, Xos, Xos, Xos, Xos, Xos, Xos, Xos, Xos, Xos, Xos, Xos, Xos, Xos, Xos, Xos, Xos, Xos, Xos, Xos, Xos, Xos, Xos, Xos, Xos, Xos, Xos, Xos, Xos, Xos, Xos, Xos, Xos, Xos, Xos, Xos, Xos, Xos
Xos, Xos, Xos, Xos, Xos, Xos, Xos, Xos, Xos, Xos, Xos, Xos, Xos, Qxua, Xos, Xos, Xos, Xos, Xos, Xos, Xos, Xos, Xos, Xos, Xos, Xos, Xos, Xos, Xos, Xos, Xos, Xos, Xos, Xos, Xos, Xos, Xos, Xos, Xos, Xos, Xos, Xos, Xos, Xos, Xos, Xos, Xos, Xos, Xos, Xos, Xos, Xos, Xos, Xos, Xos
Xos, Xos, Xos, Xos, Xos, Xos, Xos, Xos, Xos, Xos, Xos, Xos, Xos, Xos, Xos, Xos, Xos, Xos, Xos, Xos, Xos, Xos, Xos, Xos, Xos, Xos, Xos, Xos, Xos, Xos, Xos, Xos, Xos, Xos, Xos, Xos, Xos, Xos, Xos, Xos, Xos, Xos, Xos, Xos, Xos, Xos, Xos, Xos, Xos, Xos, Xos, Xos, Xos, Xos, Xos
Xos, Xos, Xos, Xos, Xos, Xos, Xos, Xos, Xos, Xos, Xos, Xos, Xos, Xos, Xos, Xos, Xos, Xos, Xos, Xos, Xos, Xos, Xos, Xos, Xos, Xos, Xos, Xos, Xos, Xos, Xos, Xos, Xos, Xos, Xos, Xos, Xos, Xos, Xos, Xos, Xos, Xos, Xos, Xos, Xos, Xos, Xos, Xos, Xos, Xos, Xos, Xos, Xos, Xos, Xos
Xos, Xos, Xos, Xos, Xos, Xos, Xos, Xos, Xos, Xos, Xos, Xos, Xos, Xos, Xos, Xos, Xos, Xos, Xos, Xos, Xos, Xos, Xos, Xos, Xos, Xos, Xos, Xos, Xos, Xos, Xos, Xos, Xos, Xos, Xos, Xos, Xos, Xos, Xos, Xos, Xos, Xos, Xos, Xos, Xos, Xos, Xos, Xos, Xos, Xos, Xos, Xos, Xos, Xos, Xos
Xos, Xos, Xos, 6 Kud, Cud, Xos, Xos, Xos, Xos, Xos, Xos, Xos, Xos, Xos, Xos, Xos, Xos, Xos, Xos, Xos, Xos, Xos, Xos, Xos, Xos, Xos, Xos, Xos, Xos, Xos, Xos, Xos, Xos, Xos, Xos, Xos, Xos, Xos, Xos, Xos, Xos, Xos, Xos, Xos, Xos, Xos, Xos, Xos, Xos, Xos, Xos, Xos, Xos, Xos, Xos
Xos, Xos, Xos, Xos, Xos, Xos, Xos, Xos, Xos, Xos, Xos, Xos, Xos, Xos, Xos, Xos, Xos, Xos, Xos, Xos, Xos, Xos, Xos, Xos, Xos, Xos, Xos, Xos, Xos, Xos, Xos, Xos, Xos, Xos, Xos, Xos, Xos, Xos, Xos, Xos, Xos, Xos, Xos, Xos, Xos, Xos, Xos, Xos, Xos, Xos, Xos, Xos, Xos, Xos, Xos
Xos, Xos, Xos, Xos, Xos, Xos, Xos, Xos, Xos, Xos, Xos, Xos, Xos, Xos, Xos, Xos, Xos, Xos, Xos, Xos, Xos, Xos, Xos, Xos, Xos, Xos, Xos, Xos, Xos, Xos, Xos, Xos, Xos, Xos, Xos, Xos, Xos, Xos, Xos, Xos, Xos, Xos, Xos, Xos, Xos, Xos, Xos, Xos, Xos, Xos, Xos, Xos, Xos, Xos, Xos
