border_size=1
usage=map

Dd, Dd, Dd, Dd, Dd, Dd, Dd, Dd, Dd, Dd, Xos, Xos, Xos, Xos, Xol, Xos, Xos, Xos, Xos, Xos, Xos, Xos, Xol, Xos, Xos, Xos, Xol, Xos, Xol, Xol, Xol, Xos, Xos, Xos, Xos, Xos, Xos, Xos, Xos, Xos, Xos, Xos, Xos, Xos, Xos, Xos, Xos, Xos, Xos, Xos, Xos, Xos, Xos, Xos, Xos
Dd, Dd, Dd, Dd, 4 Dd, Dd, 5 Dd, Dd, Xos, Xos, Cud, Xos, Xos, Xol, Urb, Urb, Urb^Dr, Rb, Rb, Urb, Urb, Rb^Dr, Rb, Xol, Xol, Xol, Cud^Vud, Cud, Urb, Xol, Rb, Rb, Rb, Rb, Rb, Xos, Xos, Xos, Xos, Xos, Rb, Xos, Xos, 1 Kud, Ur, Xos, Xos, Xos, Ur, Xos, Xos, Xos, Xos, Xos, Xos
Dd, Dd^Vdt, 2 Dd, 3 Rd, Rd, Rd, Rd, Xos, Xos, Cud, Cud, Cud, Cud^Vud, Xos, Xos, Urb, Rb, Urb, Rb, Urb, Xos, Rb^Dr, Urb, Rb, Urb, Xol, Cud, Urb, Urb, Urb, Cud, Rb^Dr, Xol, Urb, Rb, Rb, Urb, Xos, Xos, Rb, Rb, Qlf, Rb, Xos, Xos, Xos, Ur, Xos, Xos, Xos, Ur, Xos, Xos, Xos, Xos
Dd, Dd, Dd, Dd, Dd, Rd, Xos, Rd, Rd, Xos, Xos, Cud, Rb, Rb, Rb, Rb, Rb, Urb, Xos, Xos, Ce, Xos, Xos, Urb^Dr, Urb, Urb, Urb, Urb, Cud, Cud, Cud, Urb, Urb, Xol, Xol, Urb, Rb, Rb^Dr, Rb, Rb, Rb^Dr, Qlf, Qlf, Rb, Rb, Xos, Xos, Xos, Ur, Xos, Xos, Xos, Ur, Xos, Xos
Dd, Dd, Xos, Xos, Xos, Rd, Rd, Rd, Cd, Rd, Re, Rb, Rb, Rb, Rb^Dr, Rb, Xos, Xos, Ce, Re, Rd, Re, Ce, Xos, Xos, Urb, Urb^Vud, Urb, Cud, Xol, Xol, Urb, Urb, Urb, Urb, Urb, Urb, Urb, Rb, Rb, Rb, Rb, Qlf, Rb, Rb, Xos, Rb, Xos, Xos, Xos, Ur, Xos, Xos, Xos, Xos
Xos, Xos, Rd, Rd, Rd, Xos, Xos, Rd, Cd, Rd^Vda, Re, Re, Rb, Xos, Xos, Xos, Rd, Rd, Re, Rd, Xos, Rd, Re, Re, Rb, Xos, Qlf, Urb, Cud^Vud, Cud, Cud, Xol, Cud, Urb^Vud, Urb, Urb, Urb, Urb, Rb, Rb^Dr, Rb, Qlf, Rb, Rb, Rb, Rb, Rb^Dr, Rb, Ur, Xos, Xos, Xos, Ur, Xos, Xos
Xos, Xos, Xos, Rd, Rd, Rd, Rd^Vda, Rd, Rd, Cd, Re, Re, Xos, Re, Re, Xos, Rd, Rd, Ce, Rd, Rd, Rd, Ce, Rb, Rb, Xos, Qlf, Qlf, Qlf, Cud, Cud^Vud, Cud, Urb, Urb, Urb, Urb, Urb, Rb, Rb, Rb, Rb, Qlf, Qlf, Rb, Rb, Rb, Rb, Rb, Xos, Xos, Xos, Xos, Xos, Xos, Xos
Xos, Iwr, Iwr, Xos, Xos, Rd, Rd, Rd, Rd, Xos, Xos, Re, Re, Re, Re, Re, Re, Xos, Xos, Re, Ce, Re, Re, Rb, Rb, Rb^Dr, Rb, Qlf, Qlf, Qlf, Qlf, Urb, Urb, Urb, Qlf, Qlf, Qlf, Rb, Urb, Rb^Dr, Rb, Rb, Rb, Rb, Rb^Dr, Rb, Rb, Xos, Xos, Xos, Xos, Xos, Xos, Xos, Xos
Xos, Iwr, Iwr, Iwr, Iwr, Xos, Xos, Rd, Xos, Xos, Rd, Xos, Rd, Re, Re, Rb^Vda, Re, Re, Re, Xos, Xos, Xos, Rd^Dr, Rd, Rb, Rb^Dr, Rb, Rb, Rb, Qlf, Qlf, Qlf, Qlf, Qlf, Qlf, Qlf, Qlf, Qlf, Qlf, Rb, Rb, Urb, Rb, Xos, Xos, Rb, Rb, Ur, Ur, Xos, Xos, Xos, Xos, Xos, Xos
Xos, Xos, Xos, Iwr, Iwr, Iwr, Iwr, Xos, Xos, Rd, Rd, Rd, Rd, Xos, Xos, Re, Re, Re, Xos, Re, Re, Xos, Xos, Rd, Rb, Rb, Rb, Rb, Rb^Vd, Rb, Rb, Qlf, Rb, Qlf, Rb, Rb^Vd, Rb, Qlf, Rb, Urb, Urb, Urb, Urb, Rb^Dr, Rb, Xos, Rb, Ur, Ur, Xos, Xos, Xos, Xos, Xos, Xos
Xos, Iwr, Iwr, Iwr, Xos, Xos, Iwr, Iwr, Iwr, Xos, Xos, Rd^Dr, Rd, Rd, Rd, Xos, Xos, Re, Re, Re, Re, Re, Re, Xos, Xos, Rd^Dr, Rb, Rb, Rb, Rb, Rb, Rb, Rb, Rb, Rb, Xos, Rb, Rb, Qlf, Rb, Xos, Xos, Urb, Rb, Rb, Xos, Ur, Rb, Ur, Ur, Xos, Xos, Xos, Xos, Xos
Xos, Iwr, Iwr, Iwr, Iwr, Xos, Xos, Iwr, Iwr, Iwr, Iwr, Rd, Xos, Rd, Rd, Xos, Rd, Xos, Xos, Re, Re, Rb^Vda, Re, Re, Re, Xos, Xos, Rb, Rd, Rb, Rb, Rb, Qlf, Qlf, Qlf, Rb, Qlf, Qlf, Qlf, Xos, Rb, Rb, Xos, Urb, Rb, Xos, Rb^Dr, Rb, Ur, Ur, Ur, Xos, Xos, Xos, Xos
Xos, Xos, Xos, Iwr, Iwr, Iwr, Hhd, Xos, Xos, Iwr, Iwr, Iwr, Rd, Xos, Xos, Rd, Rd, Rd, Rd, Xos, Xos, Re, Re^Dr, Re, Xos, Re, Re, Xos, Xos, Rd^Dr, Rd, Rd^Dr, Rd, Qlf, Qlf, Qlf, Qlf, Qlf, Hhd, Xos, Xos, Rb, Rb, Rb, Rb, Xos, Xos, Rb, Xos, Ur^Dr, Ur, Xos, Xos, Xos, Xos
Xos, Hhd^Ftp, Gs^Ftp, Xos, Xos, Gd, Gs, Gd, Gs^Ftd, Xos, Xos, Rd, Rd, Rd, Rd, Xos, Rd, Rd, Rd^Dr, Rd, Rd, Xos, Xos, Re, Re, Re, Qxua^Xo, Qxua^Xo, Re, Xos, Rd, Rd, Rd, Rd, Xos, Qlf, Rd, Hhd, Rd, Hhd^Vhh, Rd, Xos, Xos, Rb, Rb, Rb^Dr, Rd, Xos, Xos, Ur, Ur, Ur, Xos, Xos, Xos
Xos, Gd^Ftp, Gs^Ftp, Hhd^Ftp, Gs, Gs, Gs^Vhc, Gd, Gd^Ftd, Gs, Hhd^Ftd, Xos, Xos, Rd^Dr, Rd, Rd, Rd, Rd, Xos, Rd, Xos, Rd, Rd, Xos, Xos, Qxua^Xo, Re, Rb^Vud, Re, Re, Re, Rd, Xos, Xos, Rd, Hhd, Rd, Rd, Xol, Rd, Rd, Rd, Hhd, Xos, Xos, Rb, Rd, Rd, Rd, Xos, Xos, Ur, Xos, Xos, Xos
Xos, Gs^Ftp, Gd^Ftp, Gs, Gd^Ftp, Wwf, Wwt, Gs^Ftp, Xos, Gs, Hhd, Gs^Ftd, Gs, Xos, Xos, Rd, Rd, Rd, Rd, Xos, Xos, Rd, Rd, Rd, Rd, Xos, Rd, Re, Re, Xos, Xos, Re, Re^Dr, Rd, Rd, Rd, Rd, Rd, Rd, Xol, Rd, Rd, Xos, Xos, Rd, Rd, Xos, Rd, Xos, Xos, Ur, Ur, Xos, Xos, Xos
Xos, Gs^Ftp, Xos, Gs, Wwf, Wwt, Wwt, Wwt, Gd^Ftp, Gs, Gd, Gs, Gd^Ftd, Gs^Ftd, Gd, Xos, Xos, Rd^Dr, Rd, Rd, Rd, Xos, Rd, Rd, Rd^Dr, Rd, Rd, Xos, Xos, Re, Re, Xos, Re, Re, Re, Xos, Xos, Hhd, Rd, Rd, Rd, Hhd, Xos, Rd, Rd, Xos, Ur, Xos, Ur, Ur, Ur, Ur, Xos, Xos, Xos
Xos, Gd, Gs, Gs, Gs^Ftd, Wwt, Wwt, Wwt, Wwt, Wwt, Gd^Vhc, Xos, Gs^Ftd, Gs, Xol, Xol, Cud, Xol, Xol, Rd, Rd, Rd^Dr, Rd, Rd, Xos, Rd, Xol, Xol, Rrc, Xol, Xol, Re, Re, Rb^Vud, Re, Re, Re, Xos, Xos, Hhd^Vhh, Rd, Rd, Rd, Rd, Hhd^Vhh, Xos, Ur, Ur, Ur^Dr, Ur, Xos, Xos, Xos, Xos, Xos
Xos, Ce, Gs^Vhc, Gd, Gs, Wot, Wot, Wwt, Wwt, Wwt, Gd, Gd^Ftd, Xol, Xol, Rb, Cud, Cud^Vud, Cud, Cud, Xol, Xol, Rd, Rd, Rd, Rrc, Xol, Rrc, Rrc, Rrc, Rrc, Rrc, Re, Xol, Re, Re, Xos, Xos, Re, Re, Xos, Xos, Hhd, Rd, Rd, Hhd, Xos, Xos, Ur, Ur, Xos, Xos, Xos, Xos, Xos, Xos
Xos, Gd, Gs, Gs, Gd, Hhd^Ftd, Ce, Wot, Wwt, Wwt, Wwf, Xos, Rb, Urb, Urb, Urb, Xos, Cud, Cud^Vud, Cud, Cud, Xol, Xol, Rrc, Rrc, Rrc, Rrc, Rrc, Xos, Rrc, Rrc, Rrc, Rrc, Xol, Xos, Re, Re, Xos, Re, Re, Re, Xos, Xos, Rd, Rd, Xos, Ur, Ur, Xos, Xos, Xos, Xos, Xos, Xos, Xos
Xos, Gd, Xos, Gd^Ftd, Gs, Gs, Gd^Ftp, Wot, Wwt, Wwt, Rb^Dr, Xos, Rb, Urb, Rb, Urb, Urb, Urb, Urb, Cud, Xol, Xol, Rrc, Rrc, Xos, Rrc, Rrc, Rrc, Rrc, Rrc, Rrc, Rrc, Xos, Xos, Rd, Rd, Rd, Re, Re, Rb^Vud, Re, Re, Re, Xos, Xos, Xos, Ur, Ur, Ur, Ur, Xos, Xos, Xos, Xos, Xos
Xos, Hhd, Gd, Gd^Ftp, Gd, Gs, Wot, Wot, Wwt, Wwf, Wwf, Rb, Rb, Xos, Xos, Urb^Dr, Urb, Urb, Xol, Xol, Rr, Rrc, Rrc, Rrc, Rrc, Rrc, Xos, Rrc, Rrc, Rrc, Ur, Xos, Xos, Rd, Rd, Rd, Rd, Rd, Xos, Re, Re, Xos, Xos, Re, Re, Xos, Xos, Ur^Dr, Ur, Ur, Xos, Xos, Xos, Xos, Xos
Xos, Hhd, Gs, Gd, Gs^Vhc, Wot, Wot, Wwt, Wwf, Wwf, Xos, Rb, Rb^Dr, Rb, Ur, Xol, Xol, Xol, Ur, Rr^Dr, Rr, Xos, Rrc, Rrc, Rrc, Rrc, Rrc, Rrc, Xos, Ur, Ur, Ur^Dr, Ur, Xos, Xos, Rd, Rd, Rd, Rd, Xos, Xos, Re, Re, Xos, Xos, Xos, Re, Xos, Xos, Xos, Xos, Xos, Xos, Xos, Xos
Xos, Gs, Gd, Gd, Gs, Wot, Xos, Rb, Wwf, Rb, Rb, Rb, Rb, Rb, Ur, Ur, Ur, Ur, Ur, Ur, Rr, Rrc, Rrc, Xos, Rrc, Rrc, Ur, Ur, Ur, Xos, Xos, Ur, Ur, Ur, Ur, Xos, Xos, Rd, Rd, Rd, Rd, Xos, Xos, Xos, Re, Xos, Xos, Re, Re, Xos, Xos, Xos, Xos, Xos, Xos
Xos, Xos, Ur, Gs, Ce, Hhd, Xos, Xos, Xos, Rb^Dr, Rb, Rb, Qxua^Bp\, Qxua, Qxua, Ur, Ur, Ur^Dr, Ur, Xos, Ur, Rr, Rrc, Rrc, Xos, Xos, Xos, Ur^Dr, Ur, Ur, Ur, Xos, Xos, Ur, Ur, Ur, Xos, Xos, Xos, Rd, Rd, Rd, Xos, Xos, Xos, Re, Re, Xos, Xos, Xos, Re, Xos, Xos, Xos, Xos
Xos, Xos, Ur, Xos, Xos, Xos, Ur, Ur, Xos, Rb, Qxua^Bp\, Qxua, Qxua, Qxua^Bp\, Qxua^Bp\, Qxua, Qxua, Ur, Ur^Dr, Ur, Rr, Rr^Dr, Xos, Xos, Xos, Xos, Ur, Ur, Ur, Ur, Ur^Dr, Ur, Ur, Xos, Xos, Xos, Xos, Xos, Xos, Xos, Xos, Xos, Xos, Xos, Xos, Xos, Xos, Xos, Re, Xos, Xos, Re, Re, Xos, Xos
Xos, Xos, Xos, Ur, Ur^Dr, Xos, Ur, Xos, Xos, Qxua, Qxua, Qxua^Bp\, Qxua^Bp\, Qxua, Qxua, Qxua^Bp\, Qxua^Bp\, Qxua, Qxua, Ur, Xos, Xos, Xos, Xos, Ur, Ur, Ur, Ur, Xos, Xos, Xos, Ur, Xos, Xos, Xos, Xos, Xos, Xos, Xos, Xos, Xos, Xos, Xos, Xos, Xos, Xos, Xos, Xos, Xos, Re, Re, Xos, Xos, Xos, Xos
Xos, Xos, Xos, Xos, Xos, Ur, Xos, Xos, Xos, Xos, Xos, Qxua, Qxua, Qxua^Bp\, Qxua^Bp\, Qxua, Qxua, Qxua^Bp\, Qxua^Bp\, Qxua, Ur, Xos, Xos, Ur, Ur^Dr, Ur, Ur, Xos, Xos, Xos, Xos, Xos, Xos, Xos, Xos, Xos, Xos, Xos, Xos, Xos, Xos, Xos, Xos, Xos, Xos, Xos, Xos, Xos, Xos, Xos, Xos, Xos, Xos, Xos, Xos
Xos, Xos, Xos, Xos, Xos, Ur, Ur, Ur, Ur, Ur, Ur, Ur, Ur, Qxua, Qxua, Qxua^Bp\, Qxua^Bp\, Qxua, Xos, Ur, Ur, Ur, Ur, Xos, Xos, Ur, Ur, Ur, Ur, Xos, Xos, Xos, Xos, Xos, Xos, Xos, Xos, Xos, Xos, Xos, Xos, Xos, Xos, Xos, Xos, Xos, Xos, Xos, Xos, Xos, Xos, Xos, Xos, Xos, Xos
Xos, Xos, Xos, Xos, Xos, Xos, Xos, Ur^Dr, Ur, Ur, Ur^Dr, Ur, Ur, Ur, Xos, Qxua, Ur, Ur, Ur, Xos, Xos, Ur^Dr, Ur, Ur, Ur, Xos, Xos, Ur, Ur, Ur^Dr, Ur, Xos, Xos, Xos, Xos, Xos, Xos, Xos, Xos, Xos, Xos, Xos, Xos, Xos, Xos, Xos, Xos, Xos, Xos, Xos, Xos, Xos, Xos, Xos, Xos
Xos, Xos, Xos, Xos, Xos, Xos, Xos, Ur, Ur, Xos, Xos, Ur, Xos, Xos, Xos, Xos, Xos, Ur, Ur^Dr, Ur, Ur, Xos, Xos, Ur, Ur, Ur^Dr, Ur, Xos, Ur, Ur, Ur, Ur, Xos, Xos, Xos, Xos, Xos, Xos, Xos, Xos, Xos, Xos, Xos, Xos, Xos, Xos, Xos, Xos, Xos, Xos, Xos, Xos, Xos, Xos, Xos
Xos, Xos, Xos, Xos, Xos, Xos, Xos, Ur, Ur, Xos, Xos, Xos, Xos, Xos, Xos, Xos, Xos, Xos, Xos, Ur, Ur, Ur, Xos, Xos, Xos, Ur, Ur, Ur, Ur, Ur, Xos, Xos, Xos, Xos, Xos, Xos, Xos, Xos, Xos, Xos, Xos, Xos, Xos, Xos, Xos, Xos, Xos, Xos, Xos, Xos, Xos, Xos, Xos, Xos, Xos
Xos, Xos, Xos, 6 Kud, Cud, Xos, Xos, Xos, Xos, Ur, Ur^Dr, Ur, Ur, Ur, Ur, Xos, Ur^Dr, Xos, Ur, Ur, Ur, Xos, Xos, Xos, Xos, Xos, Xos, Ur, Xos, Xos, Xos, Xos, Xos, Xos, Xos, Xos, Xos, Xos, Xos, Xos, Xos, Xos, Xos, Xos, Xos, Xos, Xos, Xos, Xos, Xos, Xos, Xos, Xos, Xos, Xos
Xos, Xos, Xos, Xos, Xos, Xos, Xos, Xos, Xos, Xos, Xos, Xos, Xos, Xos, Xos, Ur, Xos, Ur, Xos, Xos, Xos, Xos, Xos, Xos, Xos, Xos, Xos, Xos, Xos, Xos, Xos, Xos, Xos, Xos, Xos, Xos, Xos, Xos, Xos, Xos, Xos, Xos, Xos, Xos, Xos, Xos, Xos, Xos, Xos, Xos, Xos, Xos, Xos, Xos, Xos
Xos, Xos, Xos, Xos, Xos, Xos, Xos, Xos, Xos, Xos, Xos, Xos, Xos, Xos, Xos, Xos, Xos, Xos, Xos, Xos, Xos, Xos, Xos, Xos, Xos, Xos, Xos, Xos, Xos, Xos, Xos, Xos, Xos, Xos, Xos, Xos, Xos, Xos, Xos, Xos, Xos, Xos, Xos, Xos, Xos, Xos, Xos, Xos, Xos, Xos, Xos, Xos, Xos, Xos, Xos
