border_size=1
usage=map

Rd, Dd, Dd, Dd, Dd, Dd, Hd, Dd, Dd, Dd, Dd, Dd, Qxe, Qxe, Dd, Dd, Dd, Dd, Dd, Dd, Dd, Dd, Gd, Xue, Xue, Xue, Xue, Xue, Xue, Xue, Xol, Xos, Xol, Xu, Xu, Xu, Xu, Xu, Xu, Xu, Xu, Xu, Xu, Xu, Xu, Xos, Xos, Xos, Xos, Xos, Xos, Xos, Xos, Xos, Xos, Xos, Xos, Xos, Xos, Xos, Xos, Xos, Xos, Xos, Xos, Xos, Xos
Rd, Rd, Rd, Dd, Hd, Dd, Hd, Dd, Hd, Dd, Hd, Hd, Qxe, Dd, Dd, Dd, Dd, Dd, Gd^Ftd, Dd, Gd^Vda, Gd^Edpp, Hhd^Ftd, Gd, Gd, Hhd, Rd, Rd, Rd, Xue, Cud, Xos, Xos, Xu, Xos, Xu, Uh, Xu, Xu, Xu, Xu, Xu, Xu, Xu, Xu, Xos, Urb, Urb, Urb, Xos, Urb^Vud, Urb, Urb, Xos, Xos, Xos, Rr, Xos, Xos, Xos, Xos, Xos, Xos, Xos, Xos, Xos, Xos
Dd, Rd, Rd, Dd, Kd, Hd, Dd^Edpp, Hd, Dd, Hd, Dd, Qxe, Dd, Dd, Dd^Ftd, Dd, Hhd, Gd, Gd^Edpp, Hhd, Wwt, Wwt, Wwt, Gd^Edpp, Gd^Do, Gd, Dd, Dd, Xue, Rd, Xue, Urb, Urb, Xol, Xol, Xos, Cud, Rb^Br/, Ur^Br\, Uu, Ur^Br\, Uh, Ur^Vu, Xu, Xu, Xos, Xos, Urb^Vud, Urb, Urb, Urb, Urb, Xos, Xos, Rr, Rr, Rr, Rr, Rr, Xos, Xos, Xos, Xos, Xos, Xos, Xos, Xos
Dd, Rd, Rd, Rd, Rd, Dd, Dd, Dd, Dd, Dd, Dd, Dd, Dd, Dd, Dd, Dd, Cd, Cd, Gd^Do, Gd^Ftp, Gd^Ftp, Wwt, Wwt, Gd^Vdt, Gd^Ftd, Gd^Edpp, Dd^Ftd, Dd, Dd, Xue, Xol, Xos, Xos, Urb, Urb, Urb, Xol, Xos, Xu, Ur^Br/, Uu, Ur^Br\, Uu^Br\, Ur, Uh, Uu, Uh, Cud, Urb^Br\, Urb, Urb^Br/, Urb, Urb, Rr, Rr, Rr, Rr, Rr, Xos, Xos, Rr, Xos, Xos, Xos, Xos, Xos, Xos
Dd, Dd, Dd^Edpp, Rd, Rd, Dd, Dd, Dd^Vdt, Dd, Cdr, Rd, Dd, Rd, Dd, Rd, Rd, Rd, Kd, Gd, Gd^Vda, Gd, Wwt, Gd^Do, Gd, Gd^Vda, Gd, Hhd, Dd, Xue, Xue, Xol, Xos, Cud, Xos, Xos, Urb, Urb, Xol, Xos, Xu, Xu, Xu, Xu, Uu^Br\, Ur^Br\, Ur, Urb^Br/, Urb^Vud, Urb^Br/, Urb^Br/, Xos, Urb^Br\, Urb^Br\, Urb, Qxua, Xos, Xos, Xos, Rr, Rr, Rr, Rr, Rr, Xos, Xos, Xos, Xos
Dd, Dd, Dd, Dd, Rd, Rd^Es, Rd, Dd, Rd^Es, Rd, Dd, Rd, Dd, Dd, Dd, Dd^Edpp, Hhd^Ftd, Cd, Hhd, Gd^Ftd, Xue, Gd^Edpp, Xue, Hhd, Xue, Xue, Xue, Xue, Xos, Xos, Urb^Dr, Urb, Urb, Urb, Urb, Urb, Xos, Urb, Urb^Dr, Xol, Xol, Urb, Xu, Uh, Uh, Ur^Br\, Wwf, Urb^Br\, Xos, Xos, Urb, Urb, Xos, Qxua, Qxua, Qxua, Qxua, Rr, Rr, Rr, Rr, Rr, Xos, Xos, Rrc, Xos, Xos
Dd, Dd, Dd, Dd, Dd, Rd, Rd, Rd, Rd, Cd, Dd, Dd, Gd^Do, Dd, Dd, Hd, Xue, Xue, Xue, Xue, Xos, Xue, Xos, Xue, Xos, Xos, Xol, Xos, Cud, Urb, Urb, Urb, Cud, Urb, Xos, Xos, Xos, Xos, Xos, Urb, Urb^Vud, Xos, Xos, Xu, Xu, Uu, Uu, Ur, Xos, Urb, Xos, Xos, Cud, Xos, Xos, Qxua, Urb^Br\, Urb, Urb, Xos, Xos, Xos, Rr, Rrc, Rrc, Rrc, Xos
Dd, Dd, Hd, Dd, Cd, Rd, Rd, Dd, Dd, Dd, Dd, Dd, Gd^Edpp, Dd, Xos, Xue, Xos, Xos, Xol, Xos, Xos, Xos, Xos, Xos, Xos, Xos, Xol, Cud, Cud^Vud, Cud, Xol, Xos, Xol, Xos, Xol, Xos, Xos, Xos, Xos, Xos, Xos, Urb, Urb, Xos, Xos, Xu, Xos, Xos, Xos, Urb, Urb, Xos, Xos, Urb, Urb, Xos, Xos, Urb^Br\, Urb^Br\, Urb, Urb, Rr, Rr, Rrc, Rrc, Rrc, Xos
Dd, Dd, Hd, Dd, Dd, Dd, Dd, Rd, 4 Dd, Dd^Vdt, 5 Dd, Dd, Xol, Xol, Cud, Xol, Urb, Xol, Urb, Cud, Urb^Dr, Rb, Rb, Urb, Urb, Rb^Dr, Rb^Vud, Xol, Xol, Xol, Cud^Vud, Cud, Urb, Xol, Rb, Rb, Rb, Rb, Rb, Xos, Xos, Xos, Xos, Cud, Rb, Xos, Xos, 1 Kud, Urb, Xos, Xos, Urb, Urb, Urb, Xos, Urb, Urb, Xos, Xos, Urb^Br\, Urb^Br\, Urb, Urb, Xos, Xos, Xos, Xos
Dd, Hd, Hd, Dd^Esd, Dd, Dd^Vdt, 2 Dd, 3 Rd, Rd, Rd^Es, Rd, Kd, Xol, Cud, Urb, Urb^Vud, Urb, Urb, Urb, Xos, Rb, Urb, Rb, Urb, Xos, Rb^Dr, Urb, Rb, Urb, Xol, Cud, Urb, Urb, Urb, Cud, Rb^Dr, Xol, Urb, Rb, Rb, Urb, Xos, Xos, Rb, Rb, Qlf, Rb, Xos, Xos, Xos, Cud, Urb, Xos, Xos, Urb, Urb, Xos, Xos, Cud, Xos, Xos, Urb^Br\, Urb^Br\, Urb, Urb, Xos, Xos
Dd, Dd, Dd^Do, Dd^Edpp, Dd^Esd, Dd, Dd, Dd, Dd, Rd, Cd, Kd, Rd^Vda, Xol, Kd, Urb, Re, Rb, Rb^Vud, Rb, Cud, Urb, Xos, Xos, Ce^Vo, Xos, Xos, Urb^Dr, Urb, Urb, Urb, Urb, Cud, Cud, Cud, Urb, Urb, Xol, Xol, Urb, Rb, Rb^Dr, Rb, Rb, Rb^Dr, Qlf, Qlf, Rb^Vud, Rb, Xos, Xos, Xos, Cud, Urb, Xos, Urb, Urb, Urb, Xos, Xos, Cud, Xos, Xos, Urb^Br\, Urb, Xos, Xos
Dd, Dd, Dd^Edpp, Dd, Dd^Edpp, Dd, Xol, Xol, Kd, Kd, Rd, Rr, Rr, Rd, Cd, Cd, Re, Rb, Rb^Dr, Rb, Xos, Xos, Ce, Re, Rd, Re, Ce, Xos, Xos, Urb, Urb^Vud, Urb, Cud, Xol, Xol, Urb, Urb, Urb, Urb, Urb, Urb^Br\, Urb, Rb^Vud, Rb, Rb, Rb, Qlf, Rb, Rb, Xos, Cud, Xos, Xos, Xos, Urb, Urb, Xos, Xos, Urb, Urb, Xos, Xos, Xos, Urb^Br|, Urb, Xos, Xos
Dd, Hd, Cdr, Dd, Xos, Xol, Xos, Hhd, Gd^Ftd, Cd, Rd, Rd^Vda, Rr, Rd, Rd^Vda, Kd, Kd, Xol, Xol, Xos, Rd, Rd, Re, Rd, Xos, Rd, Re, Re, Rb, Xos, Qlf, Qlf, Cud^Vud, Cud, Cud, Xol, Cud, Urb^Vud, Urb^Br/, Urb^Br/, Urb^Dr, Urb^Br\, Rb^Br\, Rb^Dr, Rb, Qlf, Cud, Rb, Rb, Rb, Rb^Dr, Cud, Cud, Xos, Urb, Xos, Urb, Urb, Urb, Xos, Urb, Urb, Urb, Urb^Br|, Urb, Xos, Xos
Dd, Hd, Hd, Gd, Xos, Wot, Wwt, Gd^Edpp, Gd^Ftd, Gd^Do, Rd^Vda, Rd, Rd, Rr, Rr, Cd, Kd, Re, Qxe, Xos, Rd, Rd, Ce, Rd, Rd, Rd, Ce, Rb, Rb, Xos, Qlf, Qlf, Ql, Cud, Cud^Vud, Cud, Urb, Urb^Br\, Urb, Urb, Urb, Rb, Rb, Rb^Br\, Rb^Br\, Qlf, Qlf, Rb^Br\, Rb^Br\, Rb^Vud, Ur, Rb, Xu, Xos, Xos, Urb, Xos, Xos, Urb, Urb, Xos, Xos, Urb, Urb^Br|, Urb, Xos, Xos
Dd, Dd, Dd, Gd, Xos, Wot, Wwt, Wwrt, Gd, Gd^Edpp, Gd, Rd, Rd^Vda, Rd, Kd, Cd, Rd, Re, Qxe, Re, Re, Xos, Xos, Re, Ce, Re, Re, Rb^Vo, Rb, Rb^Dr, Rb, Qlf, Ql, Ql, Ql, Urb, Urb, Urb^Dr, Qlf, Qlf, Qlf, Qlf, Urb, Rb^Dr, Rb, Rb^Br\, Rb^Br/, Rb^Br/, Rb^Dr, Rb^Br\, Rb^Br\, Xu, Xu, Xos, Xos, Xos, Xos, Xos, Xos, Xos, Urb, Urb, Urb^Br/, Urb^Br/, Xos, Xos, Xos
Dd, Dd, Gd^Edpp, Xos, Wwt, Wwt, Wwt, Wwf, Cd, Kd, Cd, Cd, Kd, Kd, Hhd, Rr, Rd, Re, Re, Re^Vda, Re, Uue, Re, Xos, Xos, Xos, Rd^Dr, Rd, Rb, Rb^Dr, Qlf, Ql, Rb^Ecf, Ql, Ql^Bcx/, Ql^Bcx/, Ql, Ql, Qlf, Qlf, Qlf, Qlf, Qlf, Rb, Rb, Urb^Vud, Rb, Xos, Xos, Rb, Rb^Br|, Ur, Cud, Xu, Xu, Xos, Xu, Xos, Xos, Urb, Urb^Br|, Urb^Br/, Xos, Xos, Xos, Xos, Xu
Dd, Gd, Xos, Xos, Chw, Wwt, Gd, Gd^Ftd, Rd, Dd, Cd, Kd, Qxe, Qxe, Qxe, Rr, Rr, Kd, Re, Re, Re, Re, Xos, Re, Rb, Xos, Xos, Rd, Rb, Rb, Rb, Ql, Rb^Vd, Rb, Rb, Ql, Rb^Edb, Ql, Rb^Edb, Rb^Vd, Rb^Edb, Qlf, Qlf^Bcx/, Urb, Urb, Urb, Urb, Rb^Dr, Wwg, Xos, Rb^Br\, Ur, Uh, Xu, Xu, Xu, Xu, Xu, Xu, Urb, Urb^Br|, Urb, Xu, Xos, Xu, Xu, Xu
Dd, Gd^Edpp, Xos, Wwf, Xos, Hhd^Ftd, Gd, Gd, Rd, Rd, Dd, Rd, Rd, Hhd^Ftd, Qxe, Hhd, Rr, Rd, Rd, Re, Xol, Re, Re, Re, Re, Rb, Uue, Xos, Xos, Rd^Dr, Ql, Ql^Bcx\, Rb, Rb, Rb, Rb^Edb, Rb^Edb, Rb^Edb, Rb^Edb, Xos, Rb^Edb, Rb^Edb, Qlf, Rb^Edb, Xos, Xos, Urb, Rb, Rb, Xos, Cud, Rb^Br\, Ur^Br\, Uu^Vu, Xu, Xu, Xu, Xu, Xu, Urb, Urb^Br|, Urb, Urb, Urb, Xu, Xu, Xu
Xos, Rp^Dr, Wwf, Wwf, Xos, Gd, Gs^Ftd, Rd, Ch, Gd, Hhd, Rd, Rd, Rd^Vl, Rd, Qxe^Bcx/, Qxe, Rd^Vda, Rd, Re, Rd, Xol, Xol, Re^Dr, Re, Rb^Vhhr, Ql, Uue^Dr, Ql, Ql, Qlf, Ql, Rd, Rb, Rb^Vd, Rb^Edb, Ql, Ql, Ql^Bcx/, Rb^Edb, Ql, Ql, Qlf, Qlf, Qlf, Rb, Xos, Urb, Rb, Xos, Rb^Dr, Rb, Ur, Ur^Br\, Uu^Br\, Uu, Uu, Xu, Uu, Uh, Urb, Urb^Br\, Urb^Br|, Urb, Urb, Xu, Xu
Xos, Wwf, Xos, Wwf, Wwf, Xos, Xos, Kh, Gd, Ch, Hhd, Dd, Xos, Rd, Dd, Rd, Rd, Qxe, Rd, Rd, Rd, Rd, Rd, Xol, Ql, Ql^Bcx\, Re^Dr, Ql, Rb, Rb^Dr, Rb^Ecf, Ql, Xos, Rd^Dr, Rd, Rd^Dr, Rd, Ql^Bcx/, Ql, Ql, Ql, Ql, Hhd, Xos, Xos, Rb, Rb, Urb, Rb, Xos, Xos, Rb, Xos, Ur^Dr, Ur^Br|, Xu, Xu, Uu, Uu, Xu, Urb, Urb, Urb^Br|, Urb, Urb, Xu, Xu
Md, Xos, Hhd, Xos, Hhd^Ftp, Wwf, Wwf, Wwf, Wwf, Gd^Do, Gs, Kh, Gs^Ftd, Xos, Xos, Cd, Rd, Rd, Rd, Kd, Re, Rd^Vda, Rd^Dr, Re, Ql, Re, Xos, Rb, Re^Dr, Re, Ql, Ql, Re, Xos, Re, Rd, Qlf, Ql, Xos, Ql, Rd, Hhd, Rd, Hhd^Vhh, Rd, Xos, Xos, Rb, Rb, Rb^Dr, Rb^Em, Xos, Xos, Uh, Ur^Br|, Ur, Ur, Uu, Uu, Xu, Xu, Urb, Urb^Br|, Urb, Xu, Xu, Xu
Md, Hhd, Md, Md, Gd^Ftp, Gs^Ftp, Gs^Ftp, Hhd^Ftp, Wwf, Gs, Gs^Vhc, Gd, Gd^Ftd, Gs, Hhd^Ftd, Xos, Xos, Rd^Dr, Rd, Cd, Rd, Rd, Xos, Re, Ql^Bcx\, Re, Re, Rb, Re, Ql^Bcx\, Ql, Rb^Vd, Re, Re, Re, Xos, Xos, Xos, Rd, Hhd, Rd, Rd, Xol, Rd, Rd, Rd, Hhd, Xos, Xos, Rb, Rb^Em, Wwf, Uu^Uf, Xu, Xu, Uh^Br\, Uu^Br\, Xu, Uu, Xu, Xuc, Xuc, Urb^Br|, Urb, Urb, Xu, Xu
Md, Md, Hhd, Md, Hhd, Hhd^Ftp, Gd^Ftp, Gs, Gd^Ftp, Wwf, Wwrt, Gs^Ftp, Xos, Gs, Hhd, Gs^Ftd, Gs, Xos, Xos, Re, Re, Rd, Rd, Ql, Re, Rr, Rr^Vhcr, Re, Re^Ecf, Ql, Ql, Re, Xol, Xol, Rb, Re, Re^Dr, Rd, Rd, Rd, Rd, Rd, Rd, Xol, Rd, Rd, Xos, Xos, Re, Re, Xu, Uh, Xu, Xu, Uu, Ur^Br|, Qxu, Uu^Br\, Uu^Br\, Uu, Xuc, Uu^Br/, Uu, Xuc, Xu, Xu, Xu
Md, Md, Gd, Gs, Gd, Gs^Ftp, Xos, Gs^Em, Wwf, Wwt, Wwt, Wwt, Gd^Ftp, Gs, Gd, Md, Gd^Ftd, Gs^Ftd, Gd, Xos, Xos, Rd^Dr, Rd, Ql, Rd, Xos, Rr, Rd, Re^Dr, Ql, Re^Ecf, Re, Re, Re, Re, Rb, Re, Re, Re, Xos, Xos, Hhd, Rd, Rd, Rd, Hhd, Xos, Re, Re, Xu, Cud^Vud, Xu, Ur, Uu^Vu, Ur^Br/, Ur^Br|, Qxu, Qxu, Ur, Uu^Br\, Ur^Br\, Uu^Br|, Xuc, Xu, Xu, Xu, Xu
Md, Hhd^Ftp, Gd, Gd^Ftp, Gd, Gs, Gs, Gs, Gs^Ftd, Wwt, Wwt, Wwt, Wwt, Wwrt, Gd^Vhc, Xos, Gs^Ftd, Gs, Xol, Xol, Cud, Xol, Xol, Ch, Rr, Rr^Dr, Rd^Ecf, Re, Xos, Ql, Xol, Xol, Ch, Ch, Xol, Re, Re, Rb^Vud, Re, Re, Re, Xos, Xos, Hhd^Vhh, Rd, Rd, Rd, Re, Hhd^Vhh, Xu, Uh, Ur, Ur^Br/, Ur^Br/, Xu, Uu, Uu, Qxu, Ur, Xu, Ur, Uu^Br\, Uu^Br\, Uu, Xu, Xu, Xu
Md, Md, Hhd, Gs, Gd, Ket, Gs^Vhc, Gd, Gs, Wot, Wot, Wwt, Wwt, Wwt, Gd^Em, Gd^Ftd, Xol, Xol, Rb, Cud, Cud^Vud, Cud, Cud, Xol, Xol, Rr, Rr, Re, Rrc, Xol, Rrc, Rrc, Rrc, Rr, Rrc, Xol, Xol, Re, Re, Xol, Xol, Re, Re, Xos, Xos, Hhd, Rd, Re, Hhd, Xu, Xu, Ur^Br/, Uh, Xu, Xu, Xu, Ur, Ur, Ur, Ur, Uu, Uu, Ur, Cud, Xu, Xu, Xu
Md, Hhd, Gd, Gd^Ftp, Hhd, Gd, Gs, Gs, Gd, Hhd^Ftd, Ket, Wot, Wwt, Wwrt, Wwf, Xos, Rb, Urb, Urb, Urb, Xos, Cud, Cud^Vud, Cud, Cud, Xol, Xol, Rr, Rrc, Rrc, Rrc^Vhcr, Rrc, Xos, Rrc^Fetd, Rrc^Vhcr, Rrc, Rrc, Xos, Rd, Re, Re, Xol, Re, Re, Re, Xos, Xos, Qxe, Uh^Uf, Xu, Uh, Ur^Br|, Xu, Xu, Xu, Uu, Uu, Uu, Xu, Uu, Ur, Xu, Xu, Cud, Xu, Xu, Xu
Md, Md, Hhd, Gd, Gs, Gd, Xos, Gd^Ftd, Gs^Do, Gs, Gd^Ftp, Wot, Wwt, Chw, Rb^Dr, Xos, Rb, Urb, Rb, Urb, Urb, Urb, Urb, Cud, Xol, Xol, Rrc, Rrc, Xos, Rrc, Rrc^Fetd, Rrc, Rrc, Rrc, Rrc, Rrc, Rr, Xos, Rd, Rd, Cud, Re, Re, Rb^Vud, Re, Re, Re^Em, Wwg, Wwf, Xos, Cud, Ur^Br|, Ur^Br\, Uu^Vu, Xu, Xu, Uu, Uu, Uh, Xu, Xu, Xu, Urb, Xu, Urb, Xu, Xu
Md, Md, Md, Gd^Ftp, Md, Hhd^Ftp, Gd, Gd^Ftp, Gd, Gs^Em, Wot, Wot, Wwt, Wwf, Wwf, Rb^Uf, Rb, Xos, Xos, Urb^Dr, Urb, Urb, Xol, Xol, Rr, Rrc, Rrc, Rrc, Rrc, Rrc, Xos, Rrc, Rrc, Rrc, Xol, Xol, Rr, Xos, Rd, Rd, Rd^Br|, Rd, Xos, Re, Re, Xol, Xol, Wwf, Wwg, Xos, Xol, Ur^Dr, Ur^Br|, Uh, Xu, Xu, Xu, Xu, Xu, Uu^Dr, Xu, Xu, Xu, Urb, Urb, Urb, Xu
Hhd, Md, Hhd^Ftp, Gd, Gd, Hhd, Gs, Gd, Gs^Vhc, Wot, Wot, Wwt, Chw, Wwf, Xos, Rb^Vu, Rb^Dr, Urb, Urb, Xol, Xol, Xol, Ur, Rr^Dr, Rr, Xos, Rrc, Rrc^Fetd, Rrc, Rrc, Rrc, Rrc, Xos, Rrc, Rr, Rr^Dr, Ur, Xos, Xos, Rd, Rd^Br|, Rd, Rd, Xos, Xos, Re^Dr, Re^Uf, Wwf, Wwf, Xol, Cud, Uu, Uu^Br|, Uh, Xu, Xu, Xos, Xu, Xol, Uu^Dr, Xol, Xos, Urb, Urb, Urb, Urb, Xu
Xos, Hhd, Xos, Hhd, Xos, Md, Gd, Gd, Gs, Wot, Wot, Rb^Uf, Wwf, Ur, Ur, Rb, Uu, Rb, Cud, Rb, Ur, Ur, Ur, Ur, Rr^Fetd, Rrc, Rrc, Xos, Rrc, Rrc^Vhcr, Rr, Rr, Wwf, Xos, Xos, Rr, Cud, Ur, Ur^Dr, Xos, Xos, Rd^Br\, Re^Br\, Sm, Sm, Sm, Wwf, Wwf, Wwg, Xos, Xos, Ur, Ur^Br|, Uu, Uu, Xu, Xos, Xol, Cud, Cud, Cud, Xol, Xol, Urb, Xos, Urb, Xos
Qxu, Qxu, Ur, Xos, Rr, Ch, Ch, Hhd, Ce, Hhd, Wog, Xos, Xos, Ur^Dr, Uu, Ur, Qxua^Bp\, Qxua, Qxua, Urb, Ur^Vhcr, Ur^Dr, Ur, Xos, Ur, Rr^Vhcr, Rrc, Rrc, Xos, Qxe, Qxe, Rr^Dr, Rr, Rr, Qxe, Xos, Xos, Ur, Rr, Ur, Ur, Xos, Xos, Re^Br|, Rb^Dr, Sm^Vhs, Wwf, Wwg, Xos, Rb^Em, Rb, Ur, Rb^Br|, Uu^Br\, Rb^Br\, Urb^Dr, Urb, Xos, Xol, Xol, Cud, Cud, Cud, Xol, Urb^Vud, Xos, Xos
Qxu, Ur^Dr, Xol, Ur, Chr, Ur, Rr, Xol, Xol, Xos, Wwg, Ur^Vud, Xos, Rb, Qxua^Bp\, Qxua, Qxua, Qxua^Bp\, Qxua^Bp\, Qxua, Qxua, Ur, Ur^Dr, Ur, Rr, Rr^Dr, Xos, Xos, Qxe, Qxe, Ur, Rr, Rr, Qxe^Bh\, Ur^Dr, Rr, Ur, Xos, Xos, Ur, Ur, Ur, Ur^Dr, Rb^Br|, Rb^Em, Wwf, Wwf, Rb^Uf, Rb, Xos, Xos, Rb, Rb^Br|, Urb^Vud, Rb, Rb^Br\, Urb^Br\, Rb, Urb, Urb, Urb, Urb, Urb, Urb, Urb^Br\, Rb, Urb
Qxu, Rr, Rr, Xol, Rr, Ur^Vhc, Ur, Rr, Ur^Dr, Xol, Rp^Em, Wwg, Xos, Qxua, Qxua, Qxua^Bp\, Qxua^Bp\, Qxua, Qxua, Qxua^Bp\, Qxua^Bp\, Qxua, Qxua, Ur, Xos, Xos, Qxe, Qxe, Ur, Ur^Dr, Ur, Rr, Qxe, Qxe, Rr, Ur, Rr, Ur, Rr, Xos, Xos, Ur^Em, Wwf, Ur^Br|, Ur^Uf, Wwf, Wwg^Vhs, Rb^Em, Rb, Re, Cud, Xos, Xos, Urb^Br\, Rb^Br\, Urb, Xos, Rb^Br\, Rb^Br\, Rb^Br/, Urb^Br\, Urb^Vud, Urb^Br/, Urb^Br/, Urb, Rb^Br\, Rb^Br\
Qxu, Uu, Rr, Ur, Qxu, Qxu, Qxu^Bcx/, Rr, Chr, Ur, Wwf, Wwf, Xos, Xos, Xos, Qxua, Qxua, Qxua^Bp\, Qxua^Bp\, Qxua, Qxua, Qxua^Bp\, Qxua^Bp\, Qxua, Urb^Dr, Xos, Qxe, Rr, Ur^Dr, Xos, Rr, Qxe, Qxe, Qxe, Rr^Em, Wwf, Ur, Ur^Dr, Ur^Em, Wwf, Ur, Xos, Xos, Ur^Br\, Wwf, Wwf, Wwg, Xos, Xos, Rb, Re, Re, Re, Re, Re^Br|, Rb, Xos, Urb^Vud, Urb, Urb, Urb, Urb^Br/, Urb, Urb, Rb, Urb, Rb
Qxu, Qxu, Qxu, Ur, Qxu, Rr, Ur, Qxu, Rp, Ur, Rp^Em, Wwf, Rp^Dr, Rp^Uf, Rp^Em, Rp^Uf, Rp^Vhcr, Qxua, Qxua, Qxua^Bp\, Qxua^Bp\, Qxua, Xos, Urb, Urb, Rb, Urb, Qxe^Bh/, Qxe, Rr, Qxe^Bh\, Qxe, Rb, Xol, Xol, Rr^Em, Rr^Dr, Ur, Xos, Rr, Ur, Rr, Rb, Xos, Wwf, Wwf, Ur^Br\, Ur^Dr, Ur, Xos, Xos, Re, Xos, Cud, Xu, Rb^Br\, Rb, Xos, Xos, Xos, Xos, Cud, Cud^Vud, Cud, Xos, Xos, Xos
Qxu, Uh, Cud, Qxu, Ur, Rr, Ur^Vud, Qxu, Qxu, Rp^Uf, Wwf, Wwf, Ur, Ur, Rp^Dr, Rp, Rp^Uf, Rp^Em, Xos, Qxua, Ur^Br\, Ur, Ur, Xos, Xos, Rb^Dr, Rb, Urb, Qxe, Qxe, Xol, Iwr, Iwr, Iwr^Dr, Rb, Xol, Xos, Xos, Ur^Dr, Rr, Rr, Ur^Dr, Ur, Rb^Uf, Wwg, Wwg^Vhs, Xos, Uu^Br\, Ur^Br\, Ur, Uh, Xos, Xu, Xu, Xu, Rb^Br|, Xu, Xu, Xu, Xu, Xos, Cud, Cud, Cud, Xos, Xu, Xu
Xu, Ur, Ur, Qxu, Qxu^Bcx/, Ur, Qxu, Qxu, Rp^Em, Rp^Em, Wwf, Rp^Uf, Rp^Em, Xue, Xue, Wwf, Xos, Xos, Urb, Xos, Xos, Ur^Br\, Ur^Br\, Wwf, Ur, Xos, Rb^Dr, Urb, Qxe^Bh\, Rb^Dr, Iwr, Xol, Iwr, Iwr, Xos, Iwr, Xol, Rr, Rr, Ur, Wwf, Ur, Xol, Rb^Em, Wwf, Wwg, Xos, Uh, Uu^Uf, Ur^Br|, Xos, Uu^Uf, Uh, Xu, Ur, Uh^Br|, Uu^Uf, Xu, Xu, Xu, Uu, Ur, Ur, Uu, Xu, Xu, Xu
Xu, Uu, Ur, Rr, Qxu, Qxu, Xos, Xos, Xos, Wwg, Wwg, Wwf, Rb^Em, Xue, Qxe, Xue, Xue, Xue, Xue, Urb, Xue, Xos, Xos, Rb^Br\, Rb, Rb, Qxe, Qxe, Qxe, Iwr, Iwr^Dr, Iwr^Vct, Iwr, Iwr, Iwr, Iwr, Iwr, Xol, Xol, Ur, Xos, Xol, Sm, Wwg, Wwf, Wwf, Wwf, Xos, Xos, Ur^Br\, Ur^Br/, Rb^Br/, Ur^Br\, Uu^Vu, Rb^Br/, Rb^Br/, Rb^Br\, Xu, Uh, Uh, Rb^Br/, Ur, Rb, Ur, Xu, Xu, Uh
Xu, Uu^Vu, Uh, Qxu, Qxu, Qxu, Xol, 6 Kud, Cud, Xos, Wwf, Uue^Uf, Uue^Uf, Rb, Rb^Dr, Rb^Uf, Rb^Vud, Uue, Rb^Br\, Xue, Rb^Dr, Xue, Rb^Br/, Rb^Br|, Uue, Qxe^Bh\, Rb, Uu, Uu^Vud, Qxu, Xos, Rb, Xos, Xos, Rr, Iwr, Iwr^Dr, Iwr, Xol, Xos, Rb^Uf, Gll^Ftr, Gll^Ftr, Wwg, Wwf, Wwg, Wwg, Wwg, Wwg, Xos, Xos, Rb, Ur^Uf, Rb^Br\, Xos, Xu, Xu, Uu^Dr, Uh, Uu^Dr, Xu, Ur^Br\, Rb^Br\, Ur^Uf, Rb^Br/, Uu^Dr, Uh
Xu, Xu, Ur^Uf, Urb, Urb, Urb, Urb, Xol, Xol, Xol, Wwg, Wwf, Wwf, Uue^Em, Uue, Rb^Br\, Rb^Br/, Rb^Br/, Uue^Uf, Rb^Br\, Rb^Br|, Rb^Br/, Xue, Xue, Qxe, Qxe, Ur, Ur, Qxu, Qxu, Xos, Xos, Rr, Rr, Xos, Rb, Iwr, Iwr, Iwr, Xol, Xol, Rb^Uf, Rb^Uf, Gll^Ftr, Gll^Ftr, Wwf, Wwg, Wwg, Wwg, Wwg, Wwg, Xos, Xol, Xos, Cud, Xu, Uh, Xu, Xu, Xu, Uu^Uf, Wwf, Wwf, Rb^Br/, Rb, Uh, Xu
Xu, Wwg, Wwf, Xos, Ur, Xol, Xos, Rb, Urb, Rb, Urb, Wwf, Wwf, Xue, Xue, Xue, Xue, Xue, Xue, Xuce, Rb^Br|, Xuce, Xue, Qxe, Uu^Vud, Uh, Ur, Uh, Qxu, Qxu, Xos, Rr, Rr, Rr, Rr, Xos, Xol, Xol, Iwr, Rb, Rb, Xol, Xol, Xos, Xos, Xos, Xos, Wog, Wog, Wwg, Wwg, Wwg, Wog, Xos, Xol, Uu, Ur, Xu, Xu, Xu, Xu, Xu, Uu^Uf, Uh, Uu, Xu, Xu
Xu, Wwg, Uu^Uf, Uu^Em, Ur, Uh, Xol, Urb, Rb, Urb, Urb, Wwf, Wwf, Wwf, Sm, Uue^Em, Xue, Xue, Uue^Uf, Rb^Dr, Rb^Br|, Rb, Rb^Em, Qxe, Rb, Rb, Rb, Uu, Qxu, Qxu, Xos, Rr, Rr, Rr, Xol, Xol, Iwr, Iwr, Iwr, Iwr^Vct, Iwr, Iwr^Dr, Xol, Xos, Xol, Rr, Rr, Xos, Xol, Wog, Wwg, Wwg, Wog, Urb, Xol, Uu^Vu, Xu, Uh, Xu, Uh, Xu, Xu, Ur, Xu, Uu, Xu, Xu
Xu, Xu, Wwf, Urb^Em, Ur, Ur, Uu, Xol, Xos, Cud, Xol, Wwg, Wwg, Wwf, Sm, Xue, Xue, Uue^Em, Wwf, Wwf, Rb^Br|, Xue, Qxe, Qxe, Qxe, Qxu, Qxu, Qxu^Bcx\, Qxu^Bcx\, Qxu, Ur, Xos, Xos, Xos, Iwr, Iwr, Iwr, Xol, Xol, Iwr, Iwr, Xol, Urb, Rb, Rb, Xol, Xol, Xol, Rb, Wwf, Wwg, Wwg, Wog, Urb, Urb, Xol, Xu, Ur, Rb, Rb, Rb, Rb, Uu, Xu, Xu, Uh, Xu
Xu, Wwg, Wwf, Uu^Uf, Uh^Em, Urb^Vud, Ur, Xu, Xu, Xol, Ur^Em, Uu^Uf, Xu, Wwg, Wwf, Rb^Uf, Rb, Rb, Wwg, Uue^Uf, Rb^Br/, Uue, Qxe, Qxe, Qxu^Bcx\, Qxu, Qxu, Qxu, Rb, Ur, Ur^Dr, Ur^Vud, Rb, Xos, Iwr, Iwr^Dr, Rb, Iwr, Xol, Xos, Xol, Cud, Urb, Urb^Vct, Urb, Urb, Cud, Urb, Urb, Wog, Wwg, Wwg, Wog, Urb, Xol, Urb, Urb, Rb, Xu, Xu, Xu, Ur^Em, Ur^Uf, Xu, Xu, Xu, Wwg
Xu, Wog, Xu, Wwf, Urb^Em, Ur, Urb, Xu, Qxu, Ur^Em, Urb, Cud, Cud^Vud, Wwg, Wwg, Uue^Em, Xue, Rb, Rb^Br|, Rb^Br/, Qxe, Qxe, Qxe, Qxu, Rb, Ur, Ur^Em, Xos, Xos, Ur, Ur, Ur, Xol, Xol, Iwr, Rb, Xol, Xol, Rr, Rr, Rr, Xol, Urb, Urb^Dr, Xos, Xos, Xos, Cud, Urb, Wwg, Wwg, Wog, Wog, Wwf, Wwf, Xol, Xos, Xos, Xu, Xu, Xu, Wwg, Xu, Uh, Xu, Wwg, Xos
Qxu, Xu, Qxu, Xu, Urb, Urb, Xu, Cud, Qxu, Qxu, Ur^Uf, Xu, Wwf, Wwg, Wwf, Xue, Xue, Xuce, Rb^Br/, Xuce, Qxe, Qxe, Xue, Xue, Uue^Uf, Rb, Ur^Uf, Wwf, Xos, Xos, Ur, Xos, Rb, Iwr, Ur, Xos, Xos, Ur^Dr, Ur, Rr^Dr, Ur, Rr, Xos, Xos, Cud, Cud, Cud, Xos, Urb, Wwg, Wwg, Wwg, Wwg, Wwf, Xos, Wwf, Wwf, Xos, Xos, Xos, Xos, Xu, Wwf, Xu, Wwg, Wwg, Xos
Xu, Qxu, Qxu^Bcx/, Qxu^Bcx/, Xu, Cud, Qxu, Qxu, Qxu, Urb, Wwf, Wwf, Wwf, Wwg, Rb^Em, Xue, Rb^Br/, Rb^Br/, Uue^Br\, Xue, Qxe, Qxe, Xue, Uue^Em, Rb, Rb, Xos, Xos, Rr, Xos, Xos, Rb, Xos, Xos, Ur, Ur, Ur, Xos, Ur, Rr, Xos, Xos, Urb, Urb, Urb, Cud, Xol, Xol, Wwf, Wog, Wwg, Wwg, Wog, Urb, Xol, Xos, Xol, Wwf, Wwf, Xos, Wwf, Wwf, Xos, Wwg, Xos, Xos, Xos
Xu, Urb, Qxu, Qxu, Qxu, Qxu, Qxu, Qxu, Urb, Urb^Dr, Wwg, Wwg, Urb, Cud, Urb^Br\, Uue^Br/, Rb^Em, Rb^Dr, Rb, Uue^Br|, Qxe, Qxe, Xue, Uue, Rb, Uue^Em, Xos, Rr, Rr, Rr, Rr, Xos, Xos, Ur^Dr, Ur, Ur^Vct, Ur, Ur, Xos, Xos, Urb, Urb, Cud, Urb, Xos, Xos, Wwf, Wwf, Urb, Wog, Wwg, Wog, Wog, Urb, Rb, Urb, Urb, Xol, Xos, Wwf, Xos, Xos, Urb, Xos, Xos, Xos, Xos
Xu, Urb, Urb, Qxu, Urb, Qxu, Ur^Em, Ur, Uh^Uf, Sm, Wwg, Wwf, Urb^Dr, Urb, Urb, Uue, Rb^Uf, Wwf, Rb^Em, Rb^Br\, Uue^Br\, Qxe, Qxe, Uue, Rb, Rb, Rb, Rr, Xos, Xos, Rr, Rr, Rr, Xos, Rr, Ur, Xos, Ur, Urb, Urb, Urb, Cud, Xos, Xos, Wwf, Wwf, Xos, Xos, Urb, Wwg, Wwg, Wog, Wog, Rb, Xos, Urb, Urb, Urb, Urb, Xos, Xos, Urb, Urb, Urb, Urb, Xos, Xos
Xu, Uu^Vu, Uu, Ur^Em, Ur, Ur, Uh, Uu, Xu, Sm, Wog, Wwg, Wwg, Urb^Em, Uue^Uf, Uue, Xue, Wwf, Wwg, Uue^Uf, Xue, Qxe, Qxe, Qxe, Qxe^Bcx/, Uue, Rb, Rb, Rb, Xos, Xos, Rr, Rr, Rr, Xos, Xos, Xos, Urb, Cud, Urb, Xos, Xos, Wwf, Wwf, Xos, Xos, Xos, Xos, Urb, Wog, Wog, Wog, Wog, Urb, Xos, Xos, Xos, Urb, Urb, Urb, Xos, Xos, Xos, Urb, Xos, Xos, Xos
Xu, Xu, Xu, Xu, Xu, Xu, Xu, Xu, Xu, Xu, Xu, Wog, Wog, Wog, Xue, Xue, Xue, Xue, Xue, Xue, Xue, Xue, Urb, Qxe, Qxe, Qxe, Qxe, Qxe, Qxe, Xos, Xos, Xos, Xos, Xos, Xos, Xos, Xos, Xos, Xos, Xos, Xos, Wwf, Xos, Xos, Xos, Xos, Xos, Xos, Xos, Wog, Wog, Wog, Wog, Xos, Xos, Xos, Xos, Xos, Xos, Xos, Xos, Xos, Xos, Xos, Xos, Xos, Xos
